ˈwaɪz.li	wisely
ˈæl.kəʊv	alcove
həʊˈtel	hotel
ˈɪnstrəmənt	instrument
belt	belt
lɑːft	loft
tiːz	tease
ˈfaɪ.bər	fibre
ˈmɔːrəli	morally
ˈɡɑːrdn	garden
ˈtʃeɪn.dʒə.bl̩	changeable
ˈnaɪsli	nicely
trəˈdɪʃənl	traditional
ˈkaʊntər	counter
ˈvæk.juːm	vacuum
ˈdəʊl.fəl	doleful
ˌæt.esˈteɪ.ʃən	attestation
frɪdʒ	fridge
ˈrɪd.l̩	riddle
kreɪv	crave
ˈtɔː.ment	torment
ˈhɑːrt.bɝːn	heartburn
swɜːv	swerve
ˈkɒɡ.nɪ.zəns	cognizance,cognizance
ˈɔːdnri	ordinary
ɡruːp	group
ˈsteɪ.pl̩	staple
əˈdɪʃn	addition
drɔːn	drawn
ˈæd.və.keɪt	advocate
nuːn	noon
ˈfrendʃɪp	friendship
dʒɔɪ	joy
kɑːˈtuːn	cartoon
feə(r)	fair
ˈæv.ə.njuː	avenue
ˈdeb.ɪt	debit
bɪˈheɪvjə(r)	behaviour
ˌdɪs.əˈbeɪ	disobey
ˈfɔːrən	foreign
prɪˈper	prepare
ˌselɪˈbreɪʃn	celebration
ˈkaʊ.bɔɪ	cowboy
əˈsend	ascend
oʊts	oats
ɪkˈsep.ʃən.əl	exceptional
ˈθer.ə.pi	therapy
ˈsker.i	scary
ˈmɪləteri	military
ˈpær.ə.ɡrɑːf	paragraph
skwɒʃ	squash
ˈnɔːml	normal
ˈdes.tɪ.ni	destiny
ˈdrʌŋ.kən	drunken
ɪkˈstɪə.ri.ər	exterior
ˈprɒv.ən.əns	provenance
ˈjʊə.rəp	Europe
ɡaɪd	guide
ˈpæsɪndʒə(r)	passenger
draʊn	drown
ˈfɝː.ðɚ.mɔːr	furthermore
kənˈtræk.tər	contractor
həˈluː.sɪ.neɪt	hallucinate
ˈplenti	plenty
təˈwɔːdz	towards
væst	vast
ˈpær.ə.daɪs	paradise
kʊkt	cooked
ˈed.ɪ.bl̩	edible
iːst	east
pɔːz	pause
ˈtɒpɪk	topic
ˈɡlɔːr.i	glory
dɪˈvel.ə.pɪŋ	developing
ˈkɔː.lɪŋ	calling
koʊˈhɪr	cohere
ˈfaɪə(r)	fire
tʌf	tough
plɒt	plot
ˈmɔː.bɪd	morbid
ˌriː.ɪnˈfɔːs	reinforce
pəˈhæps	perhaps
dʒæz	jazz
ˈruːmər	rumour
skɔːrtʃ	scorch
læm	lamb
ˈpætn	pattern
ˈɒkjupaɪd	occupied
nɪtʃ	niche
ˈbɜːθdeɪ	birthday
mʌnθ	month
sepˈtembər	September
koʊk	coke
θred	thread
ˈprɑː.sɪ.kjuː.t̬ɚ	prosecutor
jɔːrˈself	yourself
loʊn	loan,lone
ˌfɔːˈtiːn	fourteen
æbˈdʌkt	abduct
ˈdeɪ.briː	debris
ˈsoʊ.lɚ	solar
ˈdɪf.ər	differ
ɪnˈves.tər	investor
ˈtjuː.mʌlt	tumult
toʊn	tone
ˈtempəreri	temporary
steɪn	stain
fɪb	fib
dɑːn	dawn,darn
bær.ɪ.ˈkeɪd	barricade
ˈfɪk.sɪd.li	fixedly
ˌriːˈbɪld	rebuild
soʊ	so,sew,sow
ˈæd.ɪkt	addict
vɜːdʒ	verge
ˈdaʊt.fəl	doubtful
ˈprəʊ.sest	processed
ˈflaɪ.ər	flyer
kwəʊˈteɪ.ʃən	quotation
striːt	street
ɪnˈsjuː	ensue
ˈkɪd.næp.ɪŋ	kidnapping
ˈprɒt.ɪ.stənt	Protestant
ˈɡreɪ.tɪŋ	grating
ˈheɪ.zi	hazy
ˈɔːlmoʊst	almost
ˈmænɪdʒə(r)	manager
ˈpɒkɪt	pocket
rɪˈzɜːrv	reserve
pætʃ	patch
ˈmæt.rəs	mattress
ˈvɑː.mɪt	vomit
ˈɔːltə(r)	alter
ˈɡəʊ.ɪŋ	going
ˈdɪs.ɪ.peɪt	dissipate
luːm	loom
ˈmiː.di.eɪt	mediate
ɪnˈvenʃn	invention
ˈlaɪ.ə.bl̩	liable
ˈkɒm.peər	compere
ruːt	route,root
ɪkˈsplɪs.ɪt	explicit
ˈsæk.rɪ.faɪs	sacrifice
frɔːd	fraud
ˈhoʊ.stɪs	hostess
ˈɑːn.wɚd	onward
ˈklæsruːm	classroom
ˈreb.əl	rebel
ˌded.ɪˈkeɪ.ʃən	dedication
ɪnˈkʌr.ɪ.dʒɪŋ	encouraging
ˈpɜːrfɪktli	perfectly
ˌedʒuˈkeɪʃn	education
ˈfiːd.bæk	feedback
ɑːk	arc,ark
draʊt	drought
ˈɔː.tɒp.si	autopsy
tel	tell
ˈmiːnɪŋ	meaning
ˈbʊlɪt	bullet
ˈtemprətʃə(r)	temperature
rɪˈsɔːs	resource
kəˈrɪk.jʊ.ləm	curriculum
ˈkɑː.lən.dɚ	colander
rʌn	run
nɒk	knock
ˈæl.bəm	album
ˌbækˈjɑːd	backyard
ˈper.ɪʃ	perish
drɑːp	drop
ɪmˈplɔɪə(r)	employer
ˈklæt̬.ɚ	clatter
mæʃ	mash
ˈpɔɪn.ti	pointy
ˈdɪʃˌwɒʃ.ər	dishwasher
ˈbʊk.i	bookie
ˈɑːr.mɚ	armour
ˈeɪn.dʒəl	angel
əˈnɔɪɪŋ	annoying
səˈspens	suspense
bækˈtɪəriə	bacteria
pæsˈtel	pastel
ˈbrɪl.i.əns	brilliance
ˈsɪmpli	simply
bɑːˈbeə.ri.ən	barbarian
ˈsed.ə.tɪv	sedative
ˈsɜː.vər	server
ˈriː.fleks	reflex
ˌdɪs.əˈplɪn.ər.i	disciplinary
ˈbɔɪ.lər	boiler
səˈvaɪv	survive
ˈsenət	senate
kənˈdʌk.tər	conductor
əˈbjuːsɪv	abusive
ˈdʒɪt.ər	jitter
məʊp	mope
bɪˈfɔːr	before
ˈsplɪn.tər	splinter
ɔːˈdæs.ə.ti	audacity
ˈkʌr.i	curry
ˈkɔːfi	coffee
ˈter.ɪ.tər.i	territory
ˈhænd.lɪŋ	handling
ˈbeɪ.biˌsɪt.ər	babysitter
ɪnˈvest	invest
ˈhær.əs	harass
ˌɪndəˈrekt	indirect
θæŋk	thank
ˈɒn.wəd	onward
ˈbɑː.stəd	bastard
ˈvəʊ.kəl	vocal
ɪkˌsper.ɪˈmen.təl	experimental
ˈkɪd.ni	kidney
kæp	cap
ˈtʌtʃ.ɪŋ	touching
ˈmæn.hʊd	manhood
ˈtiːtʃər	teacher
kənˈsen.səs	consensus
suːˈpɜː.flu.əs	superfluous
ˈmeɪbi	maybe
tʌtʃ	touch
ˈmʌŋ.ki	monkey
ˈhɑːrdli	hardly
ˈpænl	panel
ɡreɪt	great,grate
ˈtʃeəmən	chairman
kəʊˈhɪə.rəns	coherence
məˈræl.ə.ti	morality
θɔː	thaw
ˈmɪd.waɪf	midwife
ˈjuːniən	union
kənˈfeʃ.ən	confession
ˈsɪz.ər	scissor
ˈfjuː.taɪl	futile
ˌɪntəˈvenʃn	intervention
ˈspaɪ.nəl	spinal
sent	sent,cent,scent
ˈhedˌkwɔːr.t̬ɚ	headquarter
dreɪn	drain
ˈhɒv.ər	hover
ɪkˈspʌl.ʃən	expulsion
nɪə(r)	near
bɪˈɡɪnɪŋ	beginning
ɪɡˈzɔː.stɪŋ	exhausting
ˈdaɪəri	diary
ˈdeɪndʒərəs	dangerous
ˈɑːmlɪs	armless
ˈprɑːpər	proper
ˈbʊk.wɜːm	bookworm
ɪr	ear
ɪnˈʃɔː(r)	insure,ensure
ˈstætʃ.uːt	statute
prəˈfesə(r)	professor
ˌɪn.təˈmiː.di.ət	intermediate
ˈpiːt.sə	pizza
ˈɡærɑːdʒ	garage
ˈiːstərn	eastern
ˈæt.ɪk	attic
ˈɪn.lənd	inland
ˈstraɪkɪŋ	striking
θrɪft	thrift
snɪk	snick
ˈevribɒdi	everybody
dɪˈzɜːrtɪd	deserted
ˈʌ.t̬ɚ	utter
ˈkɒm.prə.maɪz	compromise
ˈæd.vɜːb	adverb
bəʊn	bone
skəʊp	scope
beər	bare
hæm	ham
dɪˈluːd	delude
ˈvaɪə.leɪt	violate
ˈlæk.ər	lacquer
wen	when
səˈspekt	suspect
ˈhændˌraɪ.tɪŋ	handwriting
dɪˈsiːv	deceive
lɝːk	lurk
ˈtæn.dʒə.bl̩	tangible
ˈsɪm.pə.θaɪz	sympathize
ˈspɪrɪt	spirit
sledʒ	sledge
kræmp	cramp
əˈten.ju.eɪt	attenuate
ˈblɪs.fəl	blissful
əbˈtruː.sɪv	obtrusive
kəˈnekʃn	connection
muːd	mood
ˈsuːpəmɑːkɪt	supermarket
ˈɔːɡəst	August
ˈhem.ɪ.sfɪər	hemisphere
ˈhʌŋ.ɡər	hunger
ˈpiː.kɒk	peacock
prɒp	prop
əˈhed	ahead
frɪz	frizz
ˈæftər	after
ʃɒt	shot
ˈpreɡ.nən.si	pregnancy
rɪˈzɔːrt	resort
ˈtrem.bl̩	tremble
skəʊld	scold
mɔː(r)	more
ɪˈmæk.jʊ.lət	immaculate
ˈbɑːtl	bottle
ˈɔːrɪndʒ	orange
pəʊk	poke
dɪˈdʒen.ə.reɪt	degenerate
ˈhæpən	happen
dɪˈkriːs	decrease
ɪnˈdʒiː.ni.əs	ingenious
ˈzəʊ.di.æk	zodiac
ˈbæriə(r)	barrier
ˈmɔːrnɪŋ	morning
brʌʃ	brush
ˈpæn.ɪk	panic
ˈfɒrən	foreign
kæʃˈɪər	cashier
ˈskwɪr.əl	squirrel
ˈdʒuː.əl	jewel
ʃɑːp	shop,sharp
ˈpɜː.dʒər.i	perjury
ˈem.bləm	emblem
ˈskɪp.ər	skipper
ˈmʌt.ər	mutter
nɔː(r)	nor
prɪnt	print
kənˈfɜːrm	confirm
ˈbʌs.l̩	bustle
ˈsæd.l̩	saddle
ˈmiː.ɡreɪn	migraine
ɡlɑːs	glass,gloss
kəˈlaɪ.də.skəʊp	kaleidoscope
ˈpɑːrləmənt	parliament
wɪðˈdrɔː	withdraw
ˈdes.pər.ət.li	desperately
kəˈrʌp.ʃən	corruption
dɪˈstɪŋk.ʃən	distinction
ˈpleɪər	player
zəʊn	zone
ˈkæl.ɪn.dər	calendar
ˌentəˈteɪnmənt	entertainment
ˈkɔːt.haʊs	courthouse
dɪˈten.ʃən	detention
ˈhɒr.ə.skəʊp	horoscope
seɪv	save
ˈkæt.ə.rækt	cataract
ˈmjʊr.əl	mural
ˌsʌbˈkɒn.ʃəs	subconscious
ɪkˈspləʊd	explode
ˈfrɑː.sti	frosty
ˈkæt.ə.pɪl.ər	caterpillar
kənˈsaɪs	concise
məʊd	mode
ɪkˈstenʃn	extension
rɪˈfreʃ.ɪŋ	refreshing
ˈkwɒr.i	quarry
pɔːr	poor,pour,pore
ˈpɒs.tʃər	posture
rʊk	rook
koʊd	code
ˈdʒep.ə.daɪz	jeopardize
ˈkɒntekst	context
heɪz	haze
ˈfɜː.vənt	fervent
laʊs	louse
ˈfɪfti	fifty
ɑːˈtɪk.jʊ.lət	articulate
əʊˈeɪ.sɪs	oasis
jelp	yelp
ˈlɪs.ən.ər	listener
rɪˈdʒekt	reject
faʊl	foul,fowl
ˌvɒl.ənˈtɪər	volunteer
ˈsniː.ki	sneaky
kənˈtraɪ.vəns	contrivance
ɪˈmædʒɪn	imagine
mætʃ	match
ˈsɜː.kəs	circus
ˈkɜːrtn	curtain
ˈdʒeli	jelly
ˈɒnɪstli	honestly
kəʊtʃ	coach
tuː	too,two
ˈlɔɪ.əl.ti	loyalty
ɡreɪp	grape
ˈkɑːŋkriːt	concrete
ˈnɪk.l̩	nickel
ˈhʌŋɡri	hungry
ˈkʌstəmə(r)	customer
ˈməʊ.tɪv	motive
ˈbɪtər	bitter
mɪr	mere
skɪm	skim
ˈnɔː.zi.əs	nauseous
ˈmɔːr.t̬əl	mortal
sæk	sack
ˈpɔɪnt.ləs	pointless
wɑːt	what
ˈlɪp.stɪk	lipstick
ˈlefˌt̬oʊ.vɚ	leftover
ɪmˈbreɪs	embrace
dɪˈtɜː.dʒənt	detergent
ˈpɪktʃər	picture
ɡɪlt	guilt
ˈɡræmə(r)	grammar
ˌvaɪəˈleɪ.ʃən	violation
ˈlʌki	lucky
əˈbeɪ	obey
ˈvæn.ɪʃ	vanish
hɝːd	herd
ˈsɔːftwer	software
ˈʃeɪm.ləs	shameless
ˈtreb.l̩	treble
klɪr	clear
ɪnˈtɜːprɪt	interpret
əˈtɒm.ɪk	atomic
ˈbreɪnpaʊər	brainpower
læp	lap
skeɪt	skate
ˈmæɡ.nət	magnet
ˈəʊ.pən.ər	opener
iˈmɜːrdʒənsi	emergency
tʃɑːdʒ	charge
ˈroʊ.lɚ	roller
ˈʃɔː.tɪdʒ	shortage
ˈmæl.ɪs	malice
ˈmɑː.ʃəl	marshal,martial
ˈmæɡ.nɪ.faɪ	magnify
ˈbɒdi	body
ˈhɒb.l̩	hobble
ˈɑːɡjumənt	argument
ˈsəʊ.fə	sofa
ˈsʌp.lɪ.mənt	supplement
əˈpiːz	appease
ˈeəkrɑːft	aircraft
roʊd	road
dæʃ	dash
peər	pear,pare
kəˈmiː.di.ən	comedian
ɪnˈdef.ɪ.nət.li	indefinitely
ɡoʊst	ghost
ɡrænt	grant
bæt	bat
ˈmɒnɪtə(r)	monitor
ˈfaɪə.rɪŋ	firing
pəˈsjuːt	pursuit
kənˈsɜːrvətɪv	conservative
fɑːr	far
ˈsɜːkəmstɑːns	circumstance
ˈhɑː.di	hardy
ˈɜːθ.kweɪk	earthquake
ˈsʌmp.tju.əs	sumptuous
wɜːrs	worse
ˈɪnər	inner
ɪts	its
dɪsˈrep.jʊ.tə.bl̩	disreputable
speə(r)	spare
plʌɡ	plug
ˌdefɪˈnɪʃn	definition
ˈheɪtrɪd	hatred
bruːz	bruise
ˈkɒm.ə	comma
ˌledʒ.ɪˈsleɪ.ʃən	legislation
ɪkˈsept	except
ɡrʌnt	grunt
ʌnˈriːznəbl	unreasonable
ˈprɪn.sɪ.pəl	principal
skwɜːt	squirt
nɑː	gnaw
pɑːrtʃ	parch
sɪˈvɪr	severe
əˈpɒn	upon
baʊt	bout
ˈlɪmɪt	limit
swet	sweat
ˈkɒm.plɪ.mənt	compliment
faɪn	fine
ɪnˈfəʊld	enfold
ˈʃæləʊ	shallow
ˈɪn.təl.ekt	intellect
ˈmʌt̬.ɚ	mutter
ˈrʌs.tɪk	rustic
ˈfɒlt.ləs	faultless
taɪp	type
trəˈdɪʃn	tradition
klaʊn	clown
ˌdɪs.ɪˈluː.ʒən	disillusion
ˈprezɪdənt	president
twɪst	twist
sɪn	sin
ˈspiːkər	speaker
prɪˈzjuːm	presume
ˈfes.tɪv	festive
ˈseɪlər	sailor
əˈluː.mɪ.nəm	aluminium
ˈɑː.mɪ.stɪs	armistice
ˈpeɪ.trən.ɪdʒ	patronage
rəˈneɪ.səns	renaissance
koʊst	coast
ˈkeɪpəbl	capable
bɪˈliːf	belief
rɪˈflek.ʃən	reflection
ˌnʌn.ðəˈles	nonetheless
ˈæn.θəm	anthem
ɡlɒs	gloss
self	self
ɪmˈpɜː.fekt	imperfect
bæsk	bask
ˈsɜː.kjʊ.lər	circular
ˈrep.lɪ.kə	replica
ˈæθ.liːt	athlete
ˈvɪktəri	victory
məˈdʒɒrəti	majority
rɪˈlæksɪŋ	relaxing
ˈsens.ləs	senseless
ˈmʌm.bl̩	mumble
ˈluː.krə.tɪv	lucrative
ɪˈmoʊʃn	emotion
ˈpen.djʊ.ləs	pendulous
təʊn	tone
ˈprɑːfɪt	profit
dʒet	jet
weɪ	way,weigh
ˈɒnə(r)	honour
snɪər	sneer
ˈfæb.jʊ.ləs	fabulous
praɪs	price
bɜːrn	burn
ˈbæs.kɪt.bɑːl	basketball
ˈklɪr.əns	clearance
ˈpæs.wɝːd	password
ˈspəʊks.mən	spokesman
ˈten.tə.tɪv	tentative
bæk	back
kɑːp	carp
ˈɑː.kɪ.tekt	architect
neɪ	neigh
ˈpen.ʃən.ər	pensioner
məˈtjʊə.rɪ.ti	maturity
ˈɒn.ər.ə.ri	honorary
ɪɡˈzekjətɪv	executive
klæp	clap
ˈsɒftli	softly
səbˈmɪʃ.ən	submission
kroʊk	croak
rɪˈklaɪn	recline
ˈkʊkɪŋ	cooking
prəˈvɪʒ.ən.əl	provisional
bliːd	bleed
ˈher.əʊ.ɪn	heroin
ˈwaɪ.li	wily
sliːk	sleek
ɪmˈpjuː.nɪ.ti	impunity
ˈɒk.jʊ.pənt	occupant
ˈnetwɜːk	network
ˈspoʊkən	spoken
ˈsensəbl	sensible
rɪˈmoʊt	remote
ˈtəʊ.neɪl	toenail
ˈməʊmənt	moment
iːz	ease
ˈproʊtest	protest
ledʒ	ledge
ɪɡˈzɪs.tɪŋ	existing
reɪk	rake
hoʊst	host
drʌm	drum
ˈdaɪ.vər	diver
ɡrɑːs	grass
ɡrɪm	grim
ˈdɪk.teɪt	dictate
ˈspiːtʃ.ləs	speechless
sɑːm	psalm
mɔːrɡ	morgue
əˈfɪn.ɪ.ti	affinity
sɝːtʃ	search
əˈnaʊns	announce
ˈdʒʌŋ.ɡl̩	jungle
frɑːst	frost
beɪð	bathe
ˈleɪzinəs	laziness
rɑːt	rot
bædʒ	badge
ˈɑːrɡjumənt	argument
ˈmænər	manner
rɪˈzɜːv	reserve
tɑːnt	taunt
prɑːˈsper.ə.t̬i	prosperity,prosperity
ˈsɜːvɪs	service
brɑːntʃ	branch
ˈplætfɔːrm	platform
ˈdʒeləs	jealous
ˈkær.ɪk.tə.raɪz	characterize
ˈpɔːr.t̬ɚ	porter
ˈwɪt.i	witty
ˈtɜː.ki	turkey
hɔːntʃ	haunch
ˈsʌmhaʊ	somehow
ˈlæd.ər	ladder
ˈvaɪə	via
ɪnˈtækt	intact
ˌɪn.fesˈteɪ.ʃən	infest
hə(r)	her
ˈmembər	member
rɑːd	rod
bʌk	buck
ˌɪm.pəˈtɜː.bə.bl̩	imperturbable
tʃɑːrdʒ	charge
ˈprɒbləm	problem
ɑːm	arm
ˈhɑː.stəl	hostile
ˈded.laɪn	deadline
boʊld	bold
dɪˌskrɪm.ɪˈneɪ.ʃən	discrimination
ˈtiː.spuːn	teaspoon
ˈɔːrdər	order
ˈpeɪn.fəl.i	painfully
rɪˈmembə(r)	remember
dʒʌmp	jump
aɪl	aisle
ɡoʊt	goat
ˈkeələs	careless
boʊlt	bolt
ðiːz	these
ˈmaɪn.fɪəld	minefield
ˈhem.ər.ɪdʒ	haemorrhage
wɔːrn	warn,worn
səˈren.dɚ	surrender
ɪnˈfektɪd	infected
braʊz	browse
ˌæs.pɪˈreɪ.ʃən	aspiration
smel	smell
ˈmjuː.tʃu.əl	mutual
weɪd	wade
mɔɪst	moist
mʌŋk	monk
ɪf	if
bɪˈlɒŋ	belong
ˈkləʊ.ʒər	closure
əˈluː.ʒən	allusion
ˌdʒʌs.tɪ.fɪˈkeɪ.ʃən	justification
ˈres.pɪ.reɪ.tər	respirator
heə(r)	hair
ˈæd.vɜːs	adverse
eɪtθ	eighth
wiːp	weep
hoʊks	hoax
kənˈdem	condemn
ˈɪn.dɪ.keɪ.tɚ	indicator
ˈrəʊ.bɒt	robot
biː	bee
ˈtaʊə(r)	tower
fraɪt	fright
stroʊk	stroke
əˈbʌn.dənt	abundant
ˈsek.sjʊə.li	sexually
kənˈsjuːmə(r)	consumer
ˈnaɪðə(r)	neither
kɑːsk	cask
rɪˈstɔːr	restore
dɪsˈtʃɑːdʒ	discharge
ˈpæt.i.əʊ	patio
ˌkæŋ.ɡərˈuː	kangaroo
ˈkwɑːntəti	quantity
ˈtwɪstɪd	twisted
bloʊn	blown
ˈkæl.ər.i	calorie
ˈɪr.foʊnz	earphones
wɝːl	whirl
kənˈtræk.ʃən	contraction
ˈɡræn.i	granny
ˌpriː.des.tɪˈneɪ.ʃən	predestination
ˈɪə.ləʊb	earlobe
ˈθretn	threaten
sɪv	sieve
kəmˈpækt	compact
miːt	meet,meat
reɪl	rail
ɔːrb	orb
təˈmɔːroʊ	tomorrow
ˈeɪprəl	April
ˈsʌm.ɪt	summit
ˈtrɒpɪkl	tropical
skuːp	scoop
ˈbɒn.ɪt	bonnet
prəˈmoʊt	promote
ˈklɪn.ɪk	clinic
zuː	zoo
ˌiːkəˈnɒmɪk	economic
ˈleʒ.ər	leisure
pərˈfɔːrməns	performance
ˌriː.kənˈsɪd.ər	reconsider
rɪˈməʊt	remote
ˈmænɪdʒ	manage
flʌʃt	flushed
duːn	dune
ˌʌndərˈwɔːtər	underwater
ˈwɔːnɪŋ	warning
ˈlɔɪəl	loyal
fɪst	fist
əˈfɜː.mə.tɪv	affirmative
əˈsɔːt	assort
ˈtʃiː.pən	cheapen
naɪt	night,knight
pɑːmp	pomp
ˈneɪ.vəl	naval,navel
ˈentər	enter
ˈbed.saɪd	bedside
ˈflæt̬.ɚ	flatter
dɪˈɡriː	degree
ˈoʊnər	owner
ˈfluː.ənt	fluent
əˈteɪn	attain
voʊɡ	vogue
ɑːˈθen.t̬ɪk	authentic
ˌjuː.nɪˈvɜː.səl	universal
maʊθ	mouth
wiː	wee
ˈsiː.krə.si	secrecy
ˈsɪl.ɪn.dər	cylinder
dreɪp	drape
ˈbɔːrdər	border
ˈkʌvər	cover
tent	tent
ˈʌltɪmət	ultimate
ˈpaʊdər	powder
ˈmɪs.aɪl	missile
dəʊˈneɪ.ʃən	donation
ˌsuː.pəˈstɪʃ.ən	superstition
ˈfjuːtʃə(r)	future
pəˈveɪ.sɪv	pervasive
ˈdʌtʃ.es	duchess
ˈrʌnə(r)	runner
ˈdɪk.teɪ.t̬ɚ	dictator
əˈmɪd	amid
ˈbær.ɪ.stər	barrister
həʊks	hoax
ˈtʃɪə.ri	cheery
ˈsentɪmiːtə(r)	centimetre
dɪˈstræk.ʃən	distraction,distraction
səˈvaɪ.vər	survivor
kənˈvɜːt	convert
ˈlaɪ.kli.hʊd	likelihood
ˌɒfˈset	offset
ɑːd	odd
biːst	beast
frɑːd	fraud
səˈpəʊ.zɪd.li	supposedly
æŋˈzaɪəti	anxiety
ˈpəʊl.tri	poultry
maɪt	might
ʌnˈsteɪ.bl̩	unstable
twɪtʃ	twitch
ˌəʊ.vəˈweɪt	overweight
ˈfɜːrmli	firmly
ˈθiː.sɪs	thesis
ɪkˈsel	excel
ˌrek.tɪ.fɪˈkeɪ.ʃən	rectify
beɪn	bane
bɪɡ	big
ləʊˈkeɪʃn	location
ˈmen.ɪs	menace
ˈseprət	separate
ɪˌlekˈtrɪsəti	electricity
ˈpeɪ.bæk	payback
ˈlʌɡɪdʒ	luggage
pəˈsɪst	persist
ˈsiː.dər	cedar
ˈheɪt.fəl	hateful
ˈtɒn.ɪk	tonic
ˈsɜːfɪs	surface
əˈraɪz	arise
əˈdʒeɪ.sənt	adjacent
əˈsaɪd	aside
ˈlʌm.bər	lumber
ˈwɔːlˌpeɪ.pər	wallpaper
ˈɡriː.di	greedy
ˈkʌlərd	coloured
kraɪ	cry
ˈhɒlədeɪ	holiday
ɪmˈpɑːsəbl	impossible
ɪˈnɪʃl	initial
ˈkæm.əl	camel
laɪˈbreə.ri.ən	librarian
ˈkləʊs.nəs	closeness
bɑːr	bar
ˈdekeɪd	decade
ˈpiː.nʌt	peanut
kəmˈpæʃ.ən	compassion
mɪdst	midst
hʌmp	hump
ˈpen.djʊ.ləm	pendulum
pəˈzɪʃn	position
ˈʃer.i	sherry
ˈnʌθɪŋ	nothing
ʃɪr	sheer,shear
kənˈsɜːvətɪv	conservative
ˈɒf.sprɪŋ	offspring
ˌsuː.pə.rɪnˈten.dənt	superintendent
ˈɒfɪs	office
dɪˈnaɪ	deny
ɪnˈθuːziæzəm	enthusiasm
ˈdes.tɪnd	destined
ɪˈnɒk.jʊ.leɪt	inoculate
ˈɡæb.l̩	gabble
ˈklɑːzət	closet
nuːd	nude
bləʊn	blown
ˈbeɪlɪ	bailey
rɪˈmɔːs	remorse
ˌdɪsəˈpɪr	disappear
bɔːd	board,bored
ˈbæriər	barrier
ˌθɜːrˈtiːn	thirteen
ˈhel.ɪˌkɒp.tər	helicopter
ˈprɒbəbl	probable
əkˈsel.ə.reɪt	accelerate
ˈstɜː.rɪŋ	stirring
hɪər	hear
skaʊl	scowl
ˈsaɪdweɪ	sideway
ˌblæsˈfiːm	blaspheme
ˈlɒdʒɪk	logic
dʌk	duck
ˈɡɑː.des	goddess
ˈsen.tɪ.ɡreɪd	centigrade
wɔːf	wharf
tɔːnt	taunt
ˈdeɪndʒə(r)	danger
ˈdɪɡ.nɪ.ti	dignity
rɪˈfreʃ.mənt	refreshment
nʌl	null
ˈpæt.i	patty
ˈræv.ən.əs	ravenous
lʌv	love
ˈæɡ.rɪ.kʌl.tʃər	agriculture
bɪˈlʌv.ɪd	beloved
ˈplʌm.ər	plumber
ˈmem.ə.raɪz	memorize
laɪ	lie
pɪɡ	pig
ˈwaɪər	wire
ˈkaʊn.səl.ər	counsellor
praɪ	pry
nɔːm	norm
əˈtjuːn	attune
əˈpɑːtmənt	apartment
ˈθiːətər	theatre
ˈmɔː.rɒn	moron
ˌpriːˈɒk.jʊ.paɪ	preoccupy
dɪˈfɜːr	defer
rɪˈfjuːzl	refusal
ˈstrɪk.ən	stricken
hoʊp	hope
fʊl	full
ˈpɜːpəs	purpose
ˈtæl.ən.tɪd	talented
ˈbrɔːdkɑːst	broadcast
kəmˈpleɪnt	complaint
ˈkwɒr.əl	quarrel
ˈhætʃ.ɪt	hatchet
deɪ	day
fɜːn	fern
ˈeɪ.kɔːn	acorn
ˈsɪr.əp	syrup
ˈθɪətə(r)	theatre
wʊl	wool
ˈɡreɪ.tər	greater
əˈɡreə.ri.ən	agrarian
ˈbær.əks	barracks
ˈmɑːr.t̬ɚ	martyr
ˈpreʃə(r)	pressure
djuːn	dune
ˈmɪliɡræm	milligram
ˈnætʃrəli	naturally
ˈpleɪ.bɔɪ	playboy
məʊn	moan
ɪnˈdjʊə.rəns	endurance
moʊst	most
poʊst	post
pɔːrk	pork
ˈləʊ.ʃən	lotion
twɪɡ	twig
fɔːl	fall
ˈbɑːðər	bother
peɪl	pale,pail
ˈaɪ.vər.i	ivory
pælˈpeɪt	palpate
leɪt	late
səˈfɪʃnt	sufficient
ɪmˈpaʊər	empower
rɪˈmɑː.kə.bli	remarkably
ˈnet.l̩	nettle
dæft	daft
ʌn.fəˈmɪl.i.ər	unfamiliar
ɡreɪs	grace
ˈpʌz.l̩	puzzle
ˈhəʊmˌkʌm.ɪŋ	homecoming
ˌkɒn.stɪˈtjuː.ʃən.əl	constitutional
dɪˈpɔːt	deport
dɪˈspætʃ	dispatch
əˈreɪnmənt	arraignment
hɔːl	hall,haul
rəʊz	rose
ˈɡræt.ɪ.tjuːd	gratitude
əˈkɔːd	accord
ˈswelɪŋ	swelling
hɑːt	heart,hot
ˌʌndəˈniːθ	underneath
ˈvæn.ɪ.ti	vanity
ˈdep.əʊ	depot
ɪmˈpɔːtnt	important
ˈtʃer.i	cherry
ˈfoʊtoʊkɑːpi	photocopy
ˈraɪvl	rival
ˈmɒt.əʊ	motto
mɪˈsteɪk	mistake
ˈletər	letter
ˈhɒrə(r)	horror
ˈsɜː.dʒɪ.kəl	surgical
ˈsæn.ɪ.ti	sanity
ˌkɒnsnˈtreɪʃn	concentration
wɪtʃ	which,witch
ˌriːˈbaʊnd	rebound
səˈsaɪəti	society
ˈferli	fairly
ɪˈreɪz	erase
ˌrep.rɪ.zenˈteɪ.ʃən	representation
ˈpɒm.pəs	pompous
ɪnˈdel.ɪ.kət	indelicate
ʃaɪ	shy
ˌmænjuˈfæktʃərə(r)	manufacturer
ˈsteɪtmənt	statement
ˈkemɪkl	chemical
ˈmeɪdʒə(r)	major
ˈveəriəs	various
ˈrem.ə.di	remedy
məˈnɪp.jʊ.lə.tɪv	manipulative
əˈlaʊd	aloud
ˈbæt.ər	batter
seɪf	safe
ˈmetl	metal
ˈskeə.krəʊ	scarecrow
ˈtʃær.ɪ.tə.bl̩	charitable
ˈsɪli	silly
ˈnefjuː	nephew
bɔɪl	boil
bəʊld	bold
ˈpæm.pər	pamper
ˈfɪz.i	fizzy
blæk	black
mɪθ	myth
ˈʃʌv.əl	shovel
ˌdep.rɪˈveɪ.ʃən	deprivation
ˈɔː.kɪd	orchid
ˈpɒp.lər	poplar
fɑː(r)	far
ˈreɪn.bəʊ	rainbow
əˈpɒk.ə.lɪps	apocalypse
ˈkɑːntent	content
ˈpəʊ.kər	poker
ˈpɪɡ.i	piggy
ˈpʌf.i	puffy
ˈtæm.pər	tamper
əbˈzɔː.bɪŋ	absorbing
ˈpɑː.keɪ	parquet
ɜːrθ	earth
ˈpɑː.vɚ.t̬i	poverty
ˈraɪ.tʃəs	righteous
æmˈbɪɡ.ju.əs	ambiguous
ˈfez.ənt	pheasant
ˈpɪk.l̩	pickle
ˈkler.ɪ.t̬i	clarity
raɪd	ride
ɡuːs	goose
ˈɪn.fənt	infant
pəˈzeʃn	possession
ɡʌt	gut
əˈnʌðə(r)	another
ˈhɑː.ti	hearty
ˈwɪst.fəl	wistful,wistful
huːf	hoof
ɡraʊl	growl
ˈmɪz.ər.ə.bl̩	miserable
ˈbrekfəst	breakfast
ˈɔːfl	awful
ˈeksərsaɪz	exercise
ɪmˈplaɪ	imply
spaɪt	spite
mɝːdʒ	merge
pəˈsɪs.tənt	persistent
kaʊnt	count
dɪˈsaɪ.pl̩	disciple
rɪˈvəʊlt	revolt
kənˈfɜːm	confirm
ˈsuːtkeɪs	suitcase
ʌpˈhəʊld	uphold
ʃɜːt	shirt
pɪl	pill
mɑːrʃ	marsh
slʌm	slum
nɑːb	knob
pɪəs	pierce
ɪmˈpʌl.sɪv	impulsive
ˈedʒukeɪt	educate
ˈtjuː.lɪp	tulip
ɪnˈhɑːns	enhance
ˈled.ən	leaden
ˈlʌs.tər	lustre
rektɪfɪˈkeɪʃn	rectification
friː	free
ʌnˈpleznt	unpleasant
ˈtʃaɪl.dɪʃ	childish
kəmˈpæt.ri.ət	compatriot
dʒeɪl	jail
ʃəʊn	shown
ˈtrædʒ.ɪk	tragic
ˈtɑː.lə.reɪt	tolerate
ɪˈvɒlv	evolve
ˈdɑː.lɪŋ	darling
suːˈpriːm	supreme
hɔːd	hoard
ˈev.ri.deɪ	everyday
ˈkɒn.ʃəns	conscience
dɪp	dip
ˌɪn.spɪˈreɪ.ʃən	inspiration
ˈredʒɪstər	register
ˈkæʒ.ju.əl.ti	casualty
ˈhɑːn.t̬ɪd	haunted
ˈsel.ər.i	celery
ʃɪt	shit
ˈɡæl.əp	gallop
ˈɒbviəsli	obviously
kənˈvenʃn	convention
ɡeɪz	gaze
bɪˈfɔː(r)	before
kənˈfɔːm	conform
ˈdeə.ri	dairy
ˌɒfˈʃɔːr	offshore
trɪk	trick
bəʊt	boat
feɪθ	faith
ˈaɪən	iron
lɑːrdʒ	large
def	deaf
bɪˈtreɪ	betray
ˈpəʊ.stɪdʒ	postage
bluː	blue
ˈnɑː.vɪs	novice
broʊˈʃʊr	brochure
mʊər	moor
ˈbɪtə(r)	bitter
ˈlaɪ.tɪŋ	lighting
mɔːrn	mourn
ˈʌn.də.wɜːld	underworld
ˈnesəsərəli	necessarily
fəʊm	foam
ˈskʌlp.tʃər	sculpture
ˈmæn.ʃən	mansion
ˈskæn.ti	scanty
rɪˈduːs	reduce
ˈmɔː.ɡɪdʒ	mortgage
ˌmær.ɪˈneɪd	marinade
ˈkɒn.fɪ.skeɪt	confiscate
dɪˈskrɪp.tɪv	descriptive
flæp	flap
ˌʌnˈfer	unfair
əˈkɔːdɪŋ	according
kəmˈbʌs.tɪ.bl̩	combustible
ɡʌʃ	gush
ˈæb.ə.twɑːr	abattoir,abattoir
kiːp	keep
ˈstɔːr.ɪdʒ	storage
dʌz	does
strəʊl	stroll
kreɪt	crate
ɪɡˈzæm	exam
kɒf	cough
ɪnˈdjuːs	induce
klʌtʃ	clutch
dɪˈlɪʃ.əs	delicious
bɪˈhɑːf	behalf
ˌəʊ.vəˈdʌn	overdone
ræŋk	rank
ænˌtɪs.ɪˈpeɪ.ʃən	anticipation
ˈfaɪə.bɔːl	fireball
ˈsekənd	second
ˈpʌn.dʒənt	pungent
struː	strew
ˌsaɪ.kiˈæt.rɪk	psychiatric
ˈdjʊərɪŋ	during
ˈskuː.tər	scooter
ˈdʒæɡ.ɪd	jagged
ˈdɒktə(r)	doctor
ɪnˈfekʃn	infection
ˈevɪdəns	evidence
ˌθɜːˈtiːn	thirteen
stɪf	stiff
ˌdiː.haɪˈdreɪ.tɪd	dehydrated
ˈlændskeɪp	landscape
juːˈtɪl.ɪ.ti	utility
ˌpɒsəˈbɪləti	possibility
ˈskaɪˌskreɪ.pər	skyscraper
ˈsɪə.rəm	serum
ɝːn	urn
ˈkʌp.keɪk	cupcake
ˈæk.siːz	axis
ˈfɪk.ʃən	fiction
ˈset.l̩.mənt	settlement
ˈmaɪnə(r)	minor
ˈkɑːliːɡ	colleague
ˈen.vi	envy
dɪˈsembər	December
ɪnˈsen.sɪ.bl̩	insensible
moʊ	mow
bɑːks	box
ˈspɪn.ɪtʃ	spinach
ˈlɪst.ləs	listless
ˈsʌl.fər	sulphur
ˈkʌləd	coloured
ˈlæp.tɒp	laptop
ɔːɡˈzɪl.i.ər.i	auxiliary
kənˈsʌl.tɪŋ	consulting
dɑːrt	dart
ˈloʊkl	local
ɡoʊld	gold
ˈkæmərə	camera
rɪtʃ	rich
ɪˈveɪ.ʒən	evasion
ˌʌn.dəˈreɪdʒ	underage
ˈrez.ə.luːt	resolute
ju	you
dʒuːn	June
dʒæm	jam
ˌbaɪ.əˈlɒdʒ.ɪ.kəl	biological
ˈɪn.ə.səns	innocence
ˈprəʊ.ɡræm.ɪŋ	programming
ˌɪn.sjʊˈleɪ.ʃən	insulation
plʌs	plus
pʌb	pub
ˈstænd.pɔɪnt	standpoint
ˈstɜː.di	sturdy
ˈdæʃ.bɔːd	dashboard
ˈbɒtəm	bottom
ˈkraɪsɪs	crisis
dəˈrekt	direct
skæm	scam
breɪs	brace
ˈpɪm.pl̩	pimple
klɒk	clock
sprɪŋ	spring
skɑːrf	scarf
əbˈstrʌkt	obstruct
ˈmɪnɪstri	ministry
ˈlevl	level
ˈluː.sən	loosen
ˈsæb.ə.tɑːʒ	sabotage
ədˈven.tʃər.əs	adventurous
əˈweə.nəs	awareness
ˈænt.lər	antler
ˈtreɪnɪŋ	training
suː	sue
ˈwaɪə(r)	wire
ˈkɒmədi	comedy
dɪˈtɜːmɪn	determine
ˈstɪki	sticky
ˈhɑːt.eɪk	heartache
fʌŋk	funk
reɪz	raise
fel	fell
ˈkɑːntest	contest
ˈfiːtʃər	feature
səˈvaɪ.vəl	survival
ˈtjuː.tər	tutor
ˈspelɪŋ	spelling
ˈdʒʌŋk.ʃən	junction,junction
vest	vest
ˈklɒzɪt	closet
leɪm	lame
əˈskjuː	askew
ˈfɪks.tʃər	fixture
ˈrek.tɪ.faɪ	rectify
ˈstreɪndʒər	stranger
ˈwɔːr.lɑːk	warlock
əˈstɒn.ɪ.ʃɪŋ	astonishing
meɪm	maim
ˈsɒl.jʊ.bl̩	soluble
iːv	eve
ˌɑːrtɪˈfɪʃl	artificial
ˈrɑː.bɚ	robber
sɚˈpæs	surpass
snaʊt	snout
ˌmɪsˈfɔː.tʃuːn	misfortune
ˈɑːrmi	army
ˈbʊf.eɪ	buffet
ˈstɪŋ.ki	stinky
ɪˈneɪn	inane
buːm	boom
ˈhəʊp.ləs	hopeless
ˌkælkjuˈleɪʃn	calculation
ˈpɑː.tɪ.kl̩	particle
smʌɡ	smug
ˈneɪbəhʊd	neighbourhood
ˈkæs.ər.əʊl	casserole
liːɡ	league
ˈlæs.ɪ.tjuːd	lassitude
ˌɪnˈbɔːn	inborn
ˌæs.əˈteɪn	ascertain
ˈɑː.ɡɒn	argon
ˈɪndeks	index
ænˈtɪp.ə.θi	antipathy
flɔː	flaw
əˈpreʃ.ən	oppression
ˈnɒk.ʃəs	noxious
ɪkˈspiː.di.ənt	expedient
ˈtwɪŋ.kl̩	twinkle
ˈeə.luːm	heirloom
ˈdɒŋ.ki	donkey
ˈhæp.i.nəs	happiness
ˈstreɪndʒli	strangely
brɪsk	brisk
wɒls	waltz
ˈprɪk.l̩.i	prickly
ˈpaʊər	power
ˈɡærɑːʒ	garage
ˈfʊt.ɪdʒ	footage
ˈper.əl	peril
ˈtaɪəd	tired
ˈæm.bʊʃ	ambush
ˈnɒv.ɪs	novice
ˈnaɪt.fɔːl	nightfall
ˈjuːnɪvɜːrs	universe
ˈkɒmən	common
ˈləʊ.ər	lower
əˈwɔːd	award
ˈkræk.ɪŋ	cracking
ˈræm.bl̩	ramble
ɪˈmens.li	immensely
ˈwɪmɪn	women
ˈevriθɪŋ	everything
ˈfɔː.tʃən.ət	fortunate
fɔːlt	fault
ˈɜːrli	early
ˈθɜːti	thirty
kriːk	creek
stʌd	stud
ˌkɒntrɪˈbjuːʃn	contribution
əˈbrʌpt	abrupt
ˈpəʊ.tənt	potent
ɔːl	all
ɡrɪn	grin
θʌmp	thump
ˈʌl.trə.saʊnd	ultrasound
ˈpɜːsənəli	personally
biːn	bean,been
pəˈsɒn.ɪ.faɪ	personify
tʃæt	chat
ˈfɪzɪkl	physical
ɝːl	earl
ˈkæp.tɪv	captive
pəˈsep.ʃən	perception
ˈrɪvə(r)	river
ˈsʌmbədi	somebody
ɪnˈvɒlvmənt	involvement
ˈaʊtlaɪn	outline
ˈrest.ləs	restless
rɔːr	roar
ˈped.ə.stəl	pedestal
ˈfɑːðər	father
bloʊk	bloke
ˈpær.ə.ti	parity
ˈnɑːlɪdʒ	knowledge
ˈɪŋɡlənd	England
ˈwiːl.tʃeər	wheelchair
ˈrez.ɪ.dəns	residence
suːˈpɜːb	superb
ˈnes.l̩	nestle
ˈdezərt	desert
əbˈzɜːrv	observe
ˈprɪznər	prisoner
koʊm	comb
skwɒt	squat
ˈlʌʃ.əs	luscious
ˌaʊtˈnʌm.bər	outnumber
pɜːdʒ	purge
ənˈles	unless
ˈfrendli	friendly
ˈwenzdeɪ	Wednesday
əˈfensɪv	offensive
kəʊm	comb
ˈɡræntʃaɪld	grandchild
ˈhɑː.lɚ	holler
əˈɡenst	against
prɒsˈper.ɪ.ti	prosperity,prosperity
kəmˈpleɪn	complain
skiː	ski
fɜːr	fur
ˈdraɪ.ər	dryer
ˌpær.əˈnɔɪ.ə	paranoia
ˈfɔːr.ɑːrm	forearm
ˈlæmp.pəʊst	lamppost
mʌd	mud
ˈkɒnfɪdənt	confident
ˈhɔːrər	horror
ˈes.əns	essence
ˈdaɪ.nə.sɔːr	dinosaur
ˈsɪn.ɪ.stər	sinister
ˈɑːf.tə.θɔːt	afterthought
ˈstrɑːˌber.i	strawberry
əˈsɜː.tɪv	assertive
ˈpraɪ.vət.li	privately
ˈmer.i.mənt	merriment
rɪˈpiːt	repeat
skɒtʃ	scotch
kəʊk	coke
əˈsɪstəns	assistance
ɪˈməʊ.baɪl	immobile
ɪnˈflɪkt	inflict
ˈpɑː.lɪ.ɡræf	polygraph
ˈɑːtɪkl	article
ˈraʊnd.ə.baʊt	roundabout
swɔːn	sworn
ˈhʌn.tər	hunter
ˈmæn.ju.əl	manual
bet	bet
ɪnˈʃʊə(r)	insure,ensure
soʊk	soak
ˈvɜː.tjuː	virtue
ˌlaɪ.əˈbɪl.ɪ.ti	liability
ɪnˈkeɪ.pə.bl̩	incapable
bɪˈsiːtʃ	beseech
dɪˈvɝːdʒ	diverge
hɪs	hiss
ɪnˈkaʊntə(r)	encounter
ˈlɪtrətʃər	literature
ʌpˈdeɪt	update
spɝːm	sperm
ˈkʌstəm	custom
ˈbɑːr.bɚ	barber
məˈnɒp.əl.i	monopoly
ˈsɪt.ju.eɪ.tɪd	situated
ˈkɑːləm	column
rɪˈspekt.fəl.i	respectfully
əˈraʊz	arouse
əˈplɔːz	applause
blɪs	bliss
sɔːft	soft
bend	bend
ˈdræɡ.ən	dragon
ˈθʌn.dər	thunder
ˈep.ɪk	epic
smaɪl	smile
dɑːt	dot,dart
ˈsteə.wel	stairwell
ˈswɒləʊ	swallow
ˈʃoʊldər	shoulder
ˈtendənsi	tendency
hɑːʃ	harsh
ˌriːˈsaɪ.kl̩	recycle
ˈhɔːn.tɪd	haunted
nuːˈmoʊ.njə	pneumonia
ˈhɒr.ɪ.bl̩	horrible
ˈɡlʌm.li	glum
ˈtɜː.mɪ.nəl	terminal
fəˈtiːɡ	fatigue
ˈmɑː.t̬oʊ	motto
kəˈlæm.ɪ.ti	calamity
flɪnt	flint
kəˈlæps	collapse
spɑːt	spot
ˈræb.ɪt	rabbit
əˈbɔːd	aboard
ˈtes.tə.mənt	testament
laɪm	lime
flaɪt	flight
ˈsliː.pi	sleepy
stɪr	steer
sɚˈvaɪ.vɚ	survivor
ˈfrɒs.ti	frosty
eɡ	egg
ˈhær.i	harry
fɔːˈmeɪ.ʃən	formation
ˈmes.ɪn.dʒər	messenger
ˈkrɑː.sɪŋ	crossing
ˈtʃɪl.i	chilly
ˈfɔː.məʊst	foremost
ɪnˈdʒɔɪmənt	enjoyment
sʌtʃ	such
tɝːf	turf
ˈfɪə.ləs	fearless
prɪˈdɪk.ʃən	prediction
ˈniːd.fəl	needful
vɒlˈkeɪ.nəʊ	volcano
ˈdaɪ.nə.maɪt	dynamite
ˈflʌf.i	fluffy
ˈpʊlˌəʊ.vər	pullover
ˈbɪt.ə.nəs	bitterness
ˈðeəfɔː(r)	therefore
ɜːrn	earn
ˈrəʊ.mæns	romance
ˌdʒen.əˈrɒs.ɪ.ti	generosity
ˌɪm.ɪˈɡreɪ.ʃən	immigration
ˈlæn.tən	lantern
bɪˈɡɪn	begin
kriːp	creep
əˈdɔːr	adore
ˈvet.ər.ən	veteran
ˈkɒp.ər	copper
bɒks	box
ˈtuːzdeɪ	Tuesday
ʃrɪŋk	shrink
tʃɑːrm	charm
ˈenvələʊp	envelope
ʌnˈbeə.rə.bl̩	unbearable
ˈsɝːfɪŋ	surfing
skrɪpt	script
spekˈtæk.jʊ.lər	spectacular
nəˌɡəʊ.ʃiˈeɪ.ʃən	negotiation
ˈdʒɪɡ.sɔː	jigsaw
tʃɔːk	chalk
ɡest	guest
səˈspen.ʃən	suspension
ˈen.i.pleɪs	anyplace
klɑː	claw
ˌmɪsˈjuːz	misuse
ɪtʃ	itch
bɪˈlɔːŋ	belong
əˈbɒr.əns	abhorrence
rɪˈstɔː(r)	restore
kiːn	keen
ˈbaɪsɪkl	bicycle
əˈkɜːr	occur
ˈɪmpækt	impact
ˈmæd.nəs	madness
mɑːʃ	marsh
ˈbær.ɪ.keɪd	barricade
ɪɡˈnəʊ.bl̩	ignoble
lɒt	lot
ˈkɑːr.t̬ən	carton
strɑː	straw
lɪnt	lint
prəˈfeʃ.ən.əl.i	professionally
ʌnˈkɒnʃəs	unconscious
ˈnəʊweə(r)	nowhere
ˈklɪəli	clearly
ˈkʌlər	colour
rɪns	rinse
ˈkɒm.pɪ.təns	competence
ˈbiː.fi	beefy
ˈfaɪnl	final
ɪˈneɪbl	enable
ˈkɒnsət	concert
ˌʌn.əˈkʌs.təmd	unaccustomed
ˈdaʊnwəd	downward
ˈʃrɪv.əl	shrivel
ˈpæŋ.kri.əs	pancreas
pleɪs	place,plaice
ˈaɪˌwɪt.nəs	eyewitness
ˈkæf.iːn	caffeine
kəˌmiː.diˈen	comedian
ˈplæs.tɚ	plaster
ˈtʌm.i	tummy
ɪkˈskleɪm	exclaim
ˈtɪm.bər	timber
sɜːf	surf
ˈɔːθər	author
ɪnˈvɪz.ɪ.bl̩	invisible
ded	dead
ˈkliː.nɪŋ	cleaning
ˈɑːrɡjuː	argue
riˈækt	react
ˈtʃɑː.pɚ	chopper
ɡraɪnd	grind
els	else
ˈrʌk.sæk	rucksack
wɪnd	wind
ˈhɜː.bəl	herbal
ˈmætər	matter
ˈfoʊtoʊ	photo
ˈnaɪt.meər	nightmare
ˈkreɪ.tər	crater
ˈeɪl.mənt	ailment
ˈdev.əl	devil
ˈbækwədz	backwards
ˈkwaɪət.li	quietly
kənˌsɪl.iˈeɪ.ʃən	conciliate
ˈbɑː.skɪt	basket
jel	yell
ˈɔːrɪdʒɪn	origin
kleft	cleft
ˈɑːpəreɪt	operate
ˈməʊ.tə.weɪ	motorway
ˈmæs.ɑːʒ	massage
ˈkɑː.pɚ	copper
ˈɒdli	oddly
ɪnˈtriːɡ	intrigue
bliːtʃ	bleach
ˌsuː.pə.rɪnˈtend	superintend
ðeɪ	they
ðʌs	thus
əˈdʒɔɪn	adjoin
dɪˈlaɪt.fəl	delightful
brɪk	brick
ˈɜːrdʒənt	urgent
bɪˈzɑːr	bizarre
kjuː	queue,cue
ləˈbɒrətri	laboratory
bæd	bad
dæd	dad
ˈkærəktə(r)	character
ˈsɒr.əʊ	sorrow
teɪm	tame
miː	me
hiːt	heat
ˈɒfn	often
fleʃ	flesh
ʌnˈdaʊtɪdli	undoubtedly
ˈkɒn.dɒm	condom
ˈkʌbəd	cupboard
bɪə(r)	beer
rɪˈviː.lɪŋ	revealing
ɪˈstreɪndʒ	estrange
kəˈlæb.ə.reɪt	collaborate
ˌɪn.dɪˈstɪŋkt	indistinct
ɪˈnɪʃəli	initially
ˈveɪ.pər	vapour
bɝːtʃ	birch
klɑːsp	clasp
ˈkɑːŋ.kɔːrd	concord
əˈkæd.ə.mi	academy
paɪk	pike
ˈkəʊ.hɔːt	cohort
dɑːns	dance
ɪˈrekt	erect
hɜːl	hurl
ˌep.ɪˈdem.ɪk	epidemic
ˈfrɔː.djʊ.lənt	fraudulent
ˈsentər	centre
ˈlɑː.bi	lobby
səˈpɔː.tɪv	supportive
doʊ	dough
ˈaɪ.læʃ	eyelash
ˈreɪŋ.kəʊt	raincoat
ˈkɑːm.ræd	comrade
həv	have
ˌrek.ə.menˈdeɪ.ʃən	recommendation
ˌdep.əˈzɪʃ.ən	deposition
dɪˈvɝː.sə.t̬i	diversity
trænzˈɡres	transgress
sluːs	sluice
ˌæb.səˈluː.ʃən	absolution
prəˈfeɪn	profane
ˈmɒn.stər	monster
kliːn	clean
dɜːt	dirt
fəˈtɑːɡrəfər	photographer
dəˈmestɪk	domestic
ˈfraɪtn	frighten
traʊt	trout
æbˈdʌk.ʃən	abduction
bi	be
ˈmʌs.əl	mussel
əˈpruːv	approve
ɪˈdʒekt	eject
stɪtʃ	stitch
ˈɒŋˌɡəʊ.ɪŋ	ongoing
ˈkɔːr.əs	chorus
faʊnˈdeɪʃn	foundation
ˈpleʒə(r)	pleasure
ˈpɒp.kɔːn	popcorn
ˈkɜːtn	curtain
poʊz	pose
ˈbeɪ.ə.nət	bayonet
du	do
ˈbækwərdz	backwards
ˌʌn.əˈtræk.tɪv	unattractive
ˈmʌʃ.i	mushy
ɡlʌm	glum
ɪˈliːɡl	illegal
sləʊ	slow
ˈstʌb.ən	stubborn
ˈswɪmɪŋ	swimming
ˌrezəˈveɪʃn	reservation
bɒs	boss
dɪˈsiːt	deceit
səʊk	soak
əˈpiːs	apiece
ˈskɪn.i	skinny
ˈkælkjuleɪt	calculate
tɔːrtʃ	torch
ˈbɑːk.sɚ	boxer
pɔː	paw
ˌɪn.tjuːˈɪʃ.ən	intuition
ˈiː.tə.bl̩	eatable
rɪˈkwest	request
ˈdet.rɪ.mənt	detriment
fesˈtɪv.ɪ.ti	festivity
pɒsˈter.ə.ti	posterity
ˌæd.əpˈteɪ.ʃən	adaptation
ˈtrɪɡ.ər	trigger
ˈiːmeɪl	email
weɪk	wake
ˈpiːsfl	peaceful
ˈvɔɪ.ɪdʒ	voyage
dɪˈtek.tər	detector
kənˈstrʌk.tɪv	constructive
ˈfɔːrwərd	forward
əˈdɔː.rə.bl̩	adorable
ˈfeɪ.təl	fatal
krʌst	crust
ʌnˈwɒn.tɪd	unwanted
prəˈfes	profess
spəʊk	spoke
tʃɪp	chip
krɑːl	crawl
ˈdiː.kɔɪ	decoy
jɜːn	yearn
stɑːrt	start
sɔːŋ	song
meɪd	made,maid
spɒt	spot
ˈsæn.wɪdʒ	sandwich
ˈpeni	penny
keɪdʒ	cage
dʒɔɪn	join
ˈdrɑː.pɚ	dropper
ˈdʒen.ə.reɪ.tər	generator
əˈtɜːni	attorney
ˈsem.iˌkoʊ.lən	semicolon
ˌəʊ.vəˈlʊk	overlook
ˈdjuː.əl	dual
ˈbenɪfɪt	benefit
dəʊl	dole
ˈpɪn.prɪk	pinprick
ˈʃɔːtli	shortly
ˈʃɪp.ɪŋ	shipping
ˈwɪnd.skriːn	windscreen
ˈlʌv.ɪŋ	loving
meɪn	main,mane
ˈliː.ʒɚ	leisure
ˈwɑː.kɚ	walker
əˈreɪndʒ	arrange
tʃɪn	chin
ˈren.ə.veɪt	renovate
ɪˈkweɪ.tər	equator
stoʊn	stone
lent	lent
ˈvɒl.ə.taɪl	volatile
ˈkaʊ.ɚ	cower
klɑːd	clod
ˌpes.ɪˈmɪs.tɪk	pessimistic
ˈpædʒ.ənt	pageant
ˈzɪl.jən	zillion
dɪˈfaɪn	define
ɪnˈdɪf.ər.əns	indifference
rɪˈseʃ.ən	recession
ˈrʌf.i.ən	ruffian
ədˈmaɪər	admire
strɪkt	strict
ˈælfəbet	alphabet
ˈwɪɡ.l̩	wiggle
ˈlæv.ɪn.dər	lavender
məʊst	most
sɒb	sob
lɪm	limb
əˌpriː.ʃiˈeɪ.ʃən	appreciation
rɪˈtriːv	retrieve
ɡet	get
ədˈvɑːns	advance
ˌsɪv.əl.aɪˈzeɪ.ʃən	civilization
əˈtaɪər	attire
lɔːs	loss
θɜːd	third
kəˈləʊ.ni.ə.lɪ.zəm	colonialism
ˈdɒl.i	dolly
ˌpɜː.sɪˈvɪər	persevere
lɒŋ	long
təˈɡeðər	together
ˈruːɪn	ruin
ˈɡɒd.fə.seɪ.kən	godforsaken
nəʊ	no,know
ˈnuː.dl̩	noodle
hɪˈstɪə.ri.ə	hysteria
ˈfʊli	fully
ɪt	It
ˌsevnˈtiːn	seventeen
pɜː	purr
wɑːz	was
ɡlɑːns	glance
ˌvɪz.ɪˈbɪl.ɪ.ti	visibility
swɪs	Swiss
ˈdræs.tɪk	drastic
skɪld	skilled
ɔː(r)	or
ˈmɜːdə(r)	murder
dɪˈzaɪn	design
ɪnˈstɔːl	install
əˈbɒl.ɪʃ	abolish
stɔːrk	stork
faɪt	fight
ˌoʊvərˈɔːl	overall
ˈæktɪv	active
ˈsleɪ.vər.i	slavery
trænsˈleɪʃn	translation
trʌmp	trump
ˈtɪpɪkl	typical
pəˈfɔːm	perform
ˈfrəʊzn	frozen
əbˈnɒk.ʃəs	obnoxious
ˈɡʌt̬.ɚ	gutter
ˈsaɪəns	science
ˌriːˈjuː.ni.ən	reunion
daɪv	dive
rɪst	wrist
θʌm	thumb
lɒdʒ	lodge
ɪˈrəʊ.ʒən	erosion
kɜːv	curve
ˈkɒliːɡ	colleague
ɡɔːrdʒ	gorge
siːd	seed,cede
ˌɪn.dɪˈspen.sə.bl̩	indispensable
ˈtʃɑːn.si	chancy
ˈpæləs	palace
tens	tense
flɪp	flip
ˈdʒuːəlri	jewellery
ˈslɑː.pi	sloppy
ˈkærət	carrot
məˈʃiːn	machine
keɪv	cave
rɪˈkwaɪəmənt	requirement
ʃrɪl	shrill
ˈfriː.lɑːns	freelance
rɪˈpəʊz	repose
siːm	seem,seam
dɪˈsɔː.dər	disorder
dɪˈpɑːrtʃər	departure
niːd	need,knead
ˈdespərət	desperate
əʊθ	oath
ˈɔːr.dɚ.li	orderly
maɪˈself	myself
ˌʌn.dəˈteɪk	undertake
ˈsmaɪ.lɪŋ	smiling
ˈdentɪst	dentist
dɪˈvɪn.ɪ.ti	divinity
rɪsk	risk
əbˈdʒek.ʃən	objection
ˌlɑːn.ʒəˈreɪ	lingerie
ˈkɔːr.dʒəl	cordial
ˈweðə(r)	whether,weather
ˈkɒŋ.kɔːd	concord
flɑːs	floss
ˌfɜːstˈhænd	firsthand
ˈræʃ.ən.əl.i	rationally
ˈpʌp.i	puppy
ˈhʌb.i	hubby
ˈnɜː.tʃər	nurture
ˈrel.ɪʃ	relish
krʌntʃ	crunch
ɡæs	gas
ˈwɔːrnɪŋ	warning
ˈɡrəʊ.ɪŋ	growing
bʌɡ	bug
ˈpɒləsi	policy
ˌɑːn.trə.prəˈnɝː	entrepreneur
ˌʌndərˈstænd	understand
əˌsoʊʃiˈeɪʃn	association
trænzˈmɪʃ.ən	transmission
ˈkɑːnsəʊl	console
rɪˈvaɪv	revive
ˈlɒr.əl	laurel
went	went
ˈɡrændɔːtər	granddaughter
biːk	beak
ˌɪn.kərˈekt	incorrect
ˈhiːd.ləs	heedless
koʊld	cold
streɪn	strain
dɪˈtek.tɪv	detective
ˈsəʊ.bər	sober
vɝːb	verb
ˈbæŋ.krʌpt	bankrupt
ˌkɒm.prɪˈhen.ʃən	comprehension
træm	tram
ˈevə(r)	ever
dɪˈfjuːz	diffuse
ˌəʊ.vəˈraɪd	override
bel	bell
tuːθ	tooth
ˈhaɪr.ɪŋ	hiring
fliːt	fleet
ˈpær.ə.ʃuːt	parachute
ˈbɪzi	busy
blæŋk	blank
ʃiːld	shield
bɪˈkʌm	become
ˈsmel.i	smelly
ˈfeɪ.ʃəl	facial
ˈel.ɪ.dʒə.bl̩	eligible
ˈkwes.tʃə.nɪŋ	questioning
ˈsɪvl	civil
flɑː	flaw
ˈnʌt.ʃel	nutshell
ˈreɪ.di.əns	radiance
ˈpriː.vjuː	preview
əˈkeɪʒn	occasion
ˈsʌb.ɜːb	suburb
ɡrɪd	grid
ˈtrævl	travel
jɑːt	yacht
ɪmˈbærəs	embarrass
məʊld	mould
tiːm	team,teem
tuːn	tune
lɪk	lick
trænˈzɪʃ.ən	transition
ˈlæt̬.ɪ.tuːd	latitude
ˈɑː.pɚ.ə.t̬ɪv	operative
ɪnˈsen.tɪv	incentive
ˈwɪndoʊ	window
ˌæksɪˈdentl	accidental
ˈlɒkʌp	lockup
tʌɡ	tug
ˈtriː.zən	treason
ˈbʌn.i	bunny
ˈreɪlroʊd	railroad
dʒɪŋks	jinx
ˈiːvz.drɒp	eavesdrop
ˈʌp.saɪd	upside
ˈpiː.ən.ɪst	pianist
ˈmɑː.kɪŋ	mocking
ˈfɑː.ɡi	foggy
tʃæns	chance
əˈnɒn.ɪ.məs	anonymous
hɒsˈpɪt.ə.bl̩	hospitable
ˈek.wɪ.ti	equity
dɔːn	dawn
ɪˈfektɪv	effective
ˈʃɔːr.t̬ɪdʒ	shortage
ˈdel.ɪ.ɡət	delegate
ˈwɜːl.puːl	whirlpool
ˌɡærənˈtiː	guarantee
ɪnˈdʌl.dʒəns	indulgence
ˌɪn.fluˈen.zə	influenza
bɔːk	balk
ˈpriːviəs	previous
pərˈsweɪd	persuade
ˈbætʃ.əl.ər	bachelor
ˈpʌp.ɪt	puppet
ˈsɑː.kæz.əm	sarcasm
ˈkrɪp.tɪk	cryptic
ˈmɪnɪstər	minister
ˌdɪs.kənˈtent	discontent
vɪnˈdɪk.tɪv	vindictive
ˈmɪnɪt	minute
ˈnɑːvl	novel
loʊf	loaf
ˈredʒɪstə(r)	register
ˈbætri	battery
ˈlʌntʃ.taɪm	lunchtime
ɪkˈsplɔːr	explore
ˌdʒen.ə r.əl.aɪˈzeɪ.ʃən	generalization
weɪl	whale,wail
ˈmɪdlənd	midland
ˈkʌvərd	covered
ˈkrɪk.ɪt	cricket
ʌpˈɡreɪd	upgrade
ˈrɪɡ.ər	rigour
ˈleɪtə(r)	later
ˈɡræn.pɑː	grandpa
ˌkɒz.məˈpɒl.ɪ.tən	cosmopolitan
kɔːk	cork
ˈpɔːl.tri	paltry
rɪˈzem.bl̩	resemble
nɑːtʃ	notch
ˈmɑːrkɪtɪŋ	marketing
ˈɪndɔːr	indoor
ˈtreɪ.tər	traitor
proʊn	prone
hæt	hat
ˈslaɪtli	slightly
slæm	slam
ɒks	ox
ɪnˈklaɪn	incline
prɪˈmɪr	premiere
nɪp	nip
ˈmɪs.tər	mister
ˈhed.i	heady
bɪˈkiː.ni	bikini
məˈskiː.təʊ	mosquito
ˈʌtəli	utterly
ˈhaɪ.dʒiːn	hygiene
pəˈren.i.əl	perennial
bɔɪ	boy
ˈiːkwəl	equal
ˌmɪdˈdeɪ	midday
ˈaɪ.bɔːl	eyeball
ˈdeɪ.ɪ.ti	deity
ˈspek.trəm	spectrum
ˈdʒɑː.ɡl̩	joggle
ˌpriːˈkɜː.sər	precursor
ˌveəriˈeɪʃn	variation
plaʊ	plough
ˈhæm.lət	hamlet
ˈmjʊə.rəl	mural
sɔːs	source,sauce
rɪˈɡret	regret
ˈtel.i	telly
ljʊər	lure
bruːd	brood
diːn	dean
ˈjestədeɪ	yesterday
ˈprɑːɡres	progress
ʌnˈnesəseri	unnecessary
ˈprəʊ.tə.kɒl	protocol
ˈkɔː.ni	corny
wʌns	once
dɪˈskʌvə(r)	discover
ˈbaʊn.dər.i	boundary
ˌdɪsəˈpɔɪnt	disappoint
bɔːs	boss
ˈluː.nə.tɪk	lunatic
rɪˈfrɪdʒəreɪtə(r)	refrigerator
ˌmed.iˈiː.vəl	medieval
dʒɪˈrɑːf	giraffe
ˈbaɪ.pɑːs	bypass
θɪŋk	think
əˈbæʃ	abash
ˈpen.i.ləs	penniless
dɪsˈrʌpt	disrupt
træmp	tramp
aɪˈrɒn.ɪk	ironic
ˈfɔː.hed	forehead
ˈbruː.təl	brutal
bæpˈtaɪz	baptize
ˈlaɪ.lək	lilac
ˈkæt.əl.ɒɡ	catalogue
ˈkreɪ.fɪʃ	crayfish
ɡrʌf	gruff
ˈlæð.ɚ	lather
ˈəʊ.və.taɪm	overtime
ˈpɑːs.taɪm	pastime
ˈlaɪt.haʊs	lighthouse
lɑːrk	lark
ɪnˈveɪd	invade
ˈmeɪkˌəʊ.vər	makeover
ˈeə.ləs	airless
snəʊ	snow
ˈɔːfli	awfully
ˈæsɪd	acid
ˈhaɪlaɪt	highlight
fraɪd	fried
ˈhæz.əd	hazard
ˈkʌdʒ.əl	cudgel
fɚˈtɪl.ə.t̬i	fertility
ˌʌndəˈstænd	understand
pelt	pelt
eɪp	ape
dɜːrt	dirt
rʌb	rub
ˈætməsfɪə(r)	atmosphere
ˌsɪm.əlˈteɪ.ni.əs	simultaneous
ˈkræn.bər.i	cranberry
ˈsuː.pər	super
ˈnɪp.l̩	nipple
bɪˈkʌm.ɪŋ	becoming
hʌm	hum
ˈdʒæn.ɪ.tər	janitor
ˈtæl.ənt	talent
mæt	matt,mat
sərˈen.dər	surrender
roʊp	rope
ˈɡriː.si	greasy
ˌmɪsˈdʒʌdʒ	misjudge
foʊ	foe
draɪv	drive
ˈɡlɪm.ər	glimmer
pəʊst	post
brʊm	broom
drʌŋk	drunk
piːt	peat
ˈdʒəʊ.vi.əl	jovial
streɪndʒ	strange
rɪˈpleɪs.mənt	replacement
mænˈkaɪnd	mankind
θəˈmɒm.ɪ.tər	thermometer
ˈdʒɑː.ɡɪŋ	jogging
ˌɪn.ɪɡˈzɔː.stɪ.bl̩	inexhaustible
ˈtemprətʃər	temperature
ˈwɪsl	whistle
dɪˈvɝːt	divert
ˈɡɒɡ.l̩	goggle
ˈwʊmən	woman
ˈmel.tɪŋ	melting
ˈsnəʊ.mæn	snowman
dɪˈsem.bl̩	dissemble
der	dare
ʃiːt	sheet
ˈhɑːloʊ	hollow
ˈbɪʃ.əp	bishop
pəˈluːt	pollute
rɑːsp	rasp
ˈsʌdənli	suddenly
ˈnɔːðən	northern
ɑːrk	arc
frɑːk	frock
ˈflaɪɪŋ	flying
trɪˈmen.dəs	tremendous
peɪs	pace
ˈleɪzi	lazy
səˈsep.tɪ.bl̩	susceptible
ˈsel.fɪʃ	selfish
ˈɪɡ.nər.ənt	ignorant
pəˈnɪn.sjʊ.lə	peninsula
ˈbæb.l̩	babble
ˌænɪˈvɜːrsəri	anniversary
ɪˈlektrɪk	electric
pəˈtrəʊl	patrol
moʊld	mould
ˈend.ləs	endless
ˈpɔːr.t̬əl	portal
ɪnˈtɛnʃən(ə)li	intentionally
ˈskæn.ər	scanner
əkˈsept	accept
ˈwɑːlɪt	wallet
ʃel	shell
rɪˈvɜːs	reverse
ˌpaɪəˈnɪər	pioneer
ˈniːd.ləs	needless
raɪl	rile
ˈdɪs.kɔːd	discord
stɔːr	store
ʃʌn	shun
roʊv	rove
ˌɪntərˈnæʃnəl	international
ˈeldəli	elderly
ˈɔːkwərd	awkward
ˈnɔːrməli	normally
ˈfrædʒ.aɪl	fragile
ˌwɑːt.soʊˈev.ɚ	whatsoever
əz	as
beə(r)	bear
ˈmɪkstʃə(r)	mixture
stɜː(r)	stir
əʊˈmɪt	omit
ˈpɔɪzənəs	poisonous
ˈbiː.haɪv	beehive
ˈhɪərɪŋ	hearing
kloʊk	cloak
ˌʌnˈkaɪnd	unkind
ˈliːtər	litre
əˈlɜːt	alert
rɪˈlɪdʒəs	religious
pæl	pal
lɔːd	lord
leɪð	lathe
ˈɡɑː.lənd	garland
ˈprəʊɡræm	program,programme
sɔːrs	source
ˈhæmər	hammer
kriːm	cream
trend	trend
ˈnær.ə.tɪv	narrative
ˈmʌm.i	mummy
ˈbedruːm	bedroom
ˈkerfl	careful
bles	bless
ˈsiː.wiːd	seaweed
ˈfaɪə.mən	fireman
kɔːrk	cork
blɝː	blur
ˈhʌndrəd	hundred
deɪt	date
ˈwʌndərfl	wonderful
ɪɡˈzædʒəreɪt	exaggerate
tjuːˈɪʃ.ən	tuition
ˌɪn.klɪˈneɪ.ʃən	inclination
ˈdʒɪŋ.ɡl̩	jingle
ˈɡeɪn.fəl	gainful
fɔː(r)	four
ˈkʌvə(r)	cover
ˈfɔːrɪst	forest
ˈspaɪdər	spider
ˌɔː.ri.enˈteɪ.ʃən	orientation
ˈprɒd.ɪ.dʒi	prodigy
ˈkɒm.reɪd	comrade
ˈwɔː.tə.frʌnt	waterfront
spend	spend
pəˈθet.ɪk	pathetic
striːk	streak
ˈaʊr.ɡlæs	hourglass
ˈhɔː.ni	horny
ˈskɒl.əp	scallop
rəˈviːn	ravine
ˈaɪ.ə.diːn	iodine
ˌɔːɡənaɪˈzeɪʃn	organization
ˈpræktɪkl	practical
ˈtʃælɪndʒɪŋ	challenging
kænd	canned
ˈmɜː.sən.ri	mercenary
ˈsɪlvə(r)	silver
ˈpærəlel	parallel
ˈpɔɪ.njənt	poignant
ˈlɪk.ər	liquor
ɡruːm	groom
dɪˈlaɪt	delight
ˈrɪŋ.kl̩	wrinkle
səˈfaɪs	suffice
ˈstɪp.jʊ.leɪt	stipulate
ˈfræŋ.kli	frankly
ˈdred.fəl	dreadful
ˌsen.tɪˈmen.təl	sentimental
ˈklæs.ɪ.faɪ	classify
ˈstɑː.kɪŋ	stocking
duːmd	doomed
bliːt	bleat
prɪˈskraɪb	prescribe
tʃʌŋk	chunk
ˈsæmpl	sample
toʊl	toll
ɪˈlɪm.ɪ.neɪt	eliminate
ˌɪn.səˈfɪʃ.ənt	insufficient
ˈret.rəʊ	retro
ɪɡˈnɔː(r)	ignore
bɜːrst	burst
dɪˈspel	dispel
ˈhæn.di.mæn	handyman
ˈstreɪ.tən	straighten
fleɪm	flame
rɪˈtriːt	retreat
ˈɑːk.tɪk	arctic
ˈkɑːmplɪkeɪt	complicate
ˈlep.əd	leopard
waɪd	wide
dɪˈpɑːrtmənt	department
ɡɪɡ	gig
ˈseɪf.ɡɑːd	safeguard
ˈheədresə(r)	hairdresser
ɑːsk	ask
ˈsɪv.ɪ.laɪz	civilize
ˈkwɪk.i	quickie
əˈpɪn.jə.neɪ.tɪd	opinionated,opinionated
kɔːf	cough
ˌɪntrəˈdjuːs	introduce
pɒt	pot
ˌɪn.dɪˈsɪʒ.ən	indecision
ˌaʊtˈsaɪd	outside
dʌtʃ	Dutch
ˈsʌf.ə.keɪt	suffocate
θrɑːŋ	throng
ˈbæʃ.fəl	bashful
ˈliːɡl	legal
kəmˈpʌl.sɪv	compulsive
naɪn	nine
lend	lend
pɪrs	pierce
ˈsɔː.nə	sauna
ˈdʒɑː.li	jolly
ˈsɝː.vɚ	server
klæk	clack
tɜːm	term
kəˈmɜːʃl	commercial
ˈædɪkwət	adequate
ˈrɪɡ.ər.əs	rigorous
ˈvɒl.i.bɔːl	volleyball
ˌæn.ti.pəˈθet.ɪk	antipathy
ˈpær.ə.saɪt	parasite
rɪˈsiːv	receive
səˈraʊnd	surround
ˈsɒk.ər	soccer
kənˈvenʃənl	conventional
ɪmˈpeɪ.ʃəns	impatience
spreɪ	spray
roʊ	row,roe
rʌm	rum
ˈflek.sɪ.bl̩	flexible
ˈɪm.ɪ.ɡreɪt	immigrate
nɔɪz	noise
oʊ	owe
ˌeksɪˈbɪʃn	exhibition
kənˈsɜːnɪŋ	concerning
ˈdɪnə(r)	dinner
dɪˈmænd	demand
ræŋ	rang
brɑːθ	broth
ˈplæt.ɪ.tjuːd	platitude
ˈpɒl.ən	pollen
ɪkˈsaɪtɪd	excited
ˌfɔːrˈtiːn	fourteen
əˈlɒt	allot
ɪnˈfɔː.mənt	informant
ˈɡæðər	gather
əˈveɪl	avail
ˈɔːr.tʃɚd	orchard
seks	sex
ɪˈmædʒɪneri	imaginary
ˈʃɒt.ɡʌn	shotgun
ˈmɑː.vəl	marvel
ɑːˈselvz	ourselves
ˈstreɪndʒə(r)	stranger
ˈsekrətri	secretary
ʃraɪn	shrine
ˈæl.ə.dʒi	allergy
ˈbækˈsit	backseat
prəˈfæn.ɪ.ti	profanity
ˈpæʃ.ən	passion
ˌɪndɪˈkeɪʃn	indication
ˈhæz.ə.dəs	hazardous
zuːˈɒl.ə.dʒi	zoology
ˈkaʊn.tə.nəns	countenance
braɪt	bright
bent	bent
kwɪz	quiz
ˈbɜː.ɡlər	burglar
sed	said
ˈdaɪ.pər	diaper
ˈaɪ.dl̩	idle
səm	some
ˈdʒɜːrnəlɪst	journalist
ˈkɒs.tjuːm	costume
jiːld	yield
bʌdʒ	budge
ˈkweɪ.vər	quaver
desk	desk
kɑːt	cart,caught
ɪˈsenʃl	essential
ˈfriːli	freely
kəʊv	cove
ɪnˈtɪm.ɪ.deɪ.tɪŋ	intimidating
ɡɪə(r)	gear
ˈkɪləmiːtə(r)	kilometre
dɪˈstɜːrb	disturb
wɪdθ	width
rɪˈkɔː.dər	recorder
prəˈpel	propel,propel
əˈmɔː.fəs	amorphous
fɔɪl	foil
ˈbeɪs.mənt	basement
rɪˈbel.i.ən	rebellion
skriːm	scream
ˈɪn.wəd	inward
ˈhuː.lɪ.ɡən	hooligan
ˈpriː.fɪks	prefix
swuːp	swoop
ɪˈkɒl.ə.dʒi	ecology
ədˈvaɪs	advice
θroʊn	throne
ˈnuː.bɔːrn	newborn
ˌmɪs.əlˈeɪ.ni.əs	miscellaneous
ˈfʌŋ.ɡəs	fungus
ˈjuː.nɪ.ti	unity
heɪ	hay
krɪˈmeɪt	cremate
ˈæb.ət	abbot
prɑːn	prawn
ˈpɑːzətɪv	positive
flʌʃ	flush
ˈæl.ɪ.baɪ	alibi
ˈæm.pl̩	ample
ˈfləʊ.ɪŋ	flowing
ɡloʊt	gloat
ɪnˈkɒm.pər.ə.bl̩	incomparable
ˈɔː.fən.ɪdʒ	orphanage
ˈsɜːveɪ	survey
ˈʃʌf.l̩	shuffle
blɒnd	blonde
ˈmæksɪməm	maximum
pəʊˈet.ɪk	poetic
ˈsɜː.fɪŋ	surfing
haʊ	how
əˈfens	offense,offence
ˈlætər	latter
prəˈtruːd	protrude
dɪˈluː.ʒən	delusion
ɪnˈtaɪs	entice
ˈnəʊz.bliːd	nosebleed
ˈsʌfə(r)	suffer
rɪˈɡret.ə.bl̩	regrettable
ˈɑːkjupaɪd	occupied
ˌaɪ.səl.eɪ.ʃən	isolation
ˈnɔː.ti	naughty
ˈsjuːtkeɪs	suitcase
kəʊ.əˈlɪʃ.ən	coalition
ˈiːkwəli	equally
ʃæm	sham
ˈɔː.dɪ.nə.rə.li	ordinarily
ˈmɜː.sɪ.fəl	merciful
ˈflaʊn.dər	flounder
ˈaɪtəm	item
ˈpɑː.lən	pollen
raʊnd	round
rəʊˈmæns	romance
ˈəʊ.ɪŋ	owing
seɪk	sake
əˈkʌmpəni	accompany
ˈtiː.di.əs	tedious
ˌkɒn.stəˈleɪ.ʃən	constellation
ˌnɒn.kəˈmɪt.əl	noncommittal
ˈnɒn.dɪ.skrɪpt	nondescript
krəˈdjuː.lə.ti	credulity
ˈper.ə.t̬i	parity
ˈkɑːnfərəns	conference
ˈæk.sɪs	axis
ˈtʃes.nʌt	chestnut
ɪnˈsɒl.jʊ.bl̩	insoluble
klaɪm	climb
məˈkæn.ɪk	mechanic
pəˈræl.ə.sɪs	paralysis
ˌdɪm.ɪˈnjuː.ʃən	diminution
ɡrəʊs	gross
saɪz	size
ˈpensl	pencil
ˈɑːnər	honour
klæsp	clasp
ˌdiː.vəˈluː.ʃən	devolution
ˌrɪə.laɪˈzeɪ.ʃən	realization
ˈdɜːti	dirty
ˈmʌt.ən	mutton
pləˈtuːn	platoon
ʃiːk	chic
ˈhɒm.ɪ.saɪd	homicide
kənˈstreɪn	constrain
ˈɒm.ɪ.nəs	ominous
ˈprɒdʒ.ə.ni	progeny
fɒnt	font
əˈtʃiːvmənt	achievement
koʊˈhɪr.ənt	coherent
ˈfræk.ʃən	fraction
ˈbʌb.li	bubbly
blɑːnd	blonde
ˈsen.tər	center
ˌwʌnˈself	oneself
ˈpæt.ənt	patent
ɪˈmɔː.təl	immortal
kənˈsɪs.tən.si	consistency
prəˈlɪf.ɪk	prolific
dɪə(r)	dear
dʒɪst	gist
ˈset.l̩d	settled
ˈfriː.zɪŋ	freezing
ˈmiːnwaɪl	meanwhile
ˈɔɪ.li	oily
ˌwɜːθˈwaɪl	worthwhile
bɪˈwɪtʃ	bewitch
kəˈmem.ə.reɪt	commemorate
send	send
wiːd	weed
ɪkˈspɔːrt	export
ˈvʌl.tʃər	vulture
ˈeɪ.li.əs	alias
ˈtræʃ.i	trashy
tjuːn	tune
soʊl	soul,sole
ˈrəʊ.lɪŋ	rolling
ˈraɪtə(r)	writer
ˈreɪ.zər	razor
bɪl	bill
ɪnˈtruː.sɪv	intrusive
rɪˈkuː.pər.eɪt	recuperate
ˈlaɪkli	likely
ˈkrɪtɪkl	critical
ˈkɪd.næp	kidnap
ˈædʒ.aɪl	agile
ˈtɑː.nɪk	tonic
θɜːrd	third
ˈkɒment	comment
vəˈraɪəti	variety
ˈklaʊ.di	cloudy
ˈkɑː.ki	cocky
ˈtjuːzdeɪ	Tuesday
pæs	pass
swɪŋ	swing
blɑːst	blast
ˈhɒs.taɪl	hostile
ɪnˈkwaɪəri	enquiry
ˈriːəl	real
huːz	whose
tʃɑːm	charm
kɔːrps	corpse
kæb	cab
ˈɪn.saɪt	insight
ˈker.i.ɚ	carrier
ˈbroʊkən	broken
ˈhɔː.frɒst	hoarfrost
ˌreprɪˈzent	represent
sɑːk	sock
ɪɡˈzæmɪn	examine
stəʊv	stove
ˈdʒoʊ.kɚ	joker
kəmˈpliːt	complete
træk	track
ət	at
tʃeə(r)	chair
toʊ	toe,tow
kəˈpæsəti	capacity
tɪn	tin
ˈfɪt.ɪŋ	fitting
præps	perhaps
ɪnˈtriː.ɡɪŋ	intriguing
moʊp	mope
pɑːtʃ	parch
ˌæp.əˈleɪ.ʃən	appellation
spaɪr	spire
ˈnærəʊ	narrow
ˈkəʊ.zi	cozy,cosy
ˈtɝː.t̬l̩	turtle
kənˈtɪnjuəs	continuous
ɪnˌθuːziˈæstɪk	enthusiastic
fer	fair,fare
ˈiː.ɡəʊ	ego
ˈdaɪət	diet
slæk	slack
floʊn	flown
ˈθiː.siːz	thesis
ˌɒb.səlˈiːt	obsolete
dɪˈspəʊ.zə.bl̩	disposable
ˈtɑːɡɪt	target
rɪˈmɑːk	remark
haʊnd	hound
dɪˈspəʊz	dispose
ɪnˈkeɪs	encase
ˈreɪdioʊ	radio
ˈkaʊnti	county
vəˈkæbjəleri	vocabulary
ˈtʃɑːr.t̬ɚ	charter
best	best
nɜːrv	nerve
pɑːˈtɪs.ɪ.peɪt	participate
ʃelf	shelf
ˈkɒm.pən.seɪt	compensate
ˌdeɡ.rəˈdeɪ.ʃən	degradation
krɪsp	crisp
ˈtʃaɪld.bɜːθ	childbirth
kənˈvɪns	convince
dɪˈskrɪpʃn	description
ˌmæk.ərˈəʊ.ni	macaroni
ˈrʌm.bl̩	rumble
ˌdʒʌk.stəˈpəʊz	juxtapose
beɪl	bail,bale
ˈsaɪd.wɔːk	sidewalk
ˈfɑːsn	fasten
təˈnaɪt	tonight
ˈkləʊðɪŋ	clothing
ˈleɪdi	lady
tʃaɪˈniːz	Chinese
ʌnˈeɪbl	unable
əˈkjuːz	accuse
səˈner.i.oʊ	scenario
sɔːrt	sort
test	test
ˈref.juːdʒ	refuge
mɑːlt	malt
əˈkɒm.ə.deɪt	accommodate
ˈsʌb.sɪ.kwənt	subsequent
ˈsɑː.sɚ	saucer
ˈleŋ.θən	lengthen
ˈmel.əŋ.kɒl.i	melancholy
ˈpjʊə.rɪ.ti	purity
bɪˈsiːdʒ	besiege
ʃɔːt	short
wətˈevər	whatever
hæf	half
vɔɪs	voice
ʌnˈhæpi	unhappy
ˈɡræv.ɪ.ti	gravity
dɪˈstɔːt	distort
haʊs	house
skɔːtʃ	scorch
ˈkɔːrn.flaʊ.ɚ	cornflower
ˈpeb.l̩	pebble
bɜːn	burn
ˈmɒdn	modern
ˈmaɪ.nəs	minus
ˈæb.strækt	abstract
ˈlaɪ.ɪŋ	lying
ˌentərˈteɪnɪŋ	entertaining
dɪˈleɪd	delayed
streɪt	straight
tɑːr	tar
ˌlɪm.ɪˈteɪ.ʃən	limitation
pəˈzes	possess
ˈɒb.stɪ.kl̩	obstacle
jiːst	yeast
ˈpɑːrtnər	partner
ˈpeɪntər	painter
ˈbʌt.lər	butler
spek	speck
ˈreɪ.zən	raisin
ˈtʃæm.pi.ən.ʃɪp	championship
liːn	lean
ɪˈfɪʃ.ən.si	efficiency
er	air,heir
ˈmʌf.ɪn	muffin
ˈæn.t̬i	auntie
ˈvɪn.tɪdʒ	vintage
ˈeriə	area
ˈkaʊn.səl	counsel
mɪnt	mint
ˈθʌrə	thorough
ɑːˈkeɪd	arcade
ˌriː.kænˈteɪ.ʃən	recant
ˈænsər	answer
ˈdʒɜː.nəl	journal
ˈwɔː.tər.i	watery
ˈkrʌʃ.ɪŋ	crushing
dʒoʊlt	jolt
əˈtætʃ.mənt	attachment
təˈtuː	tattoo
sænd	sand
dɪˌtɜːmɪˈneɪʃn	determination
nɑːd	nod
ˈæs.trə.nɔːt	astronaut
ɡreɪz	graze
ˈhɪroʊ	hero
ˈdep.jʊ.ti	deputy
fʌdʒ	fudge
ɪnˈspaɪər	inspire
ˈhɑːt.bɜːn	heartburn
kwel	quell
ˈmeɪdʒər	major
ˈɡɒs.ɪp	gossip
ˈtraɪ.əmf	triumph
sæt	sat
fʌn	fun
trænsˈfɜːr	transfer
fəˈsɪləti	facility
ˈkræp.i	crappy
ˈfaɪr.ɑːrm	firearm
ʃɔː(r)	sure
ˈæl.ɔɪ	alloy
sɜːtʃ	search
ˈbʌm.pər	bumper
ˈkɜː.nəl	colonel,kernel
ˈpɑː.ʃəl.i	partially
məˌnɪp.jʊˈleɪ.ʃən	manipulation
ðən	than
ˈkliː.nər	cleaner
froʊz	froze
ˌæɡ.rɪˈkʌl.tʃər.əl	agricultural
ˈkɪŋ.ki	kinky
priːtʃ	preach
ʃrʌɡ	shrug
ˈpɪti	pity
tʃɪər	cheer
ˈkɒm.pər.ə.bl̩	comparable
krɔːl	crawl
bækˈsteɪdʒ	backstage
ˈsʌn.raɪz	sunrise
ˈlɪn.i.ər	linear
ˈsʌmər	summer
ˈfləʊ.tɪŋ	floating
bɔːr	bore,boar
ˈkæp.ʃən	caption
kəʊˈhɪə.rənt	coherent
kənˈsɪst	consist
ˈbəʊ.ɡəs	bogus
ˈɑː.t̬ə.ɡræf	autograph
ˈkæsl	castle
rɑːθ	wrath
krɪˈden.ʃəl	credential
ˈskɪlfl	skilful
aɪˈrɑː.nɪk	ironic
bræs	brass
ˈklɪn.ɪ.kəl	clinical
ˈæm.jʊ.lət	amulet
əˈliː.dʒəns	allegiance
ˈwɔːtər	water
ˈpɑː.plɚ	poplar
ˈlɪkwɪd	liquid
dɪˈluː.ʒən.əl	delusional
nɑːk	knock
ˈleɪbl	label
ˈʌt.ər	utter
ˈdʌs.ti	dusty
əˈtenʃn	attention
ʌlˈtɪə.ri.ər	ulterior
fɑːnd	fond
ˈpɜːmɪt	permit
ɪnˈhjuː.mən	inhuman
ˈsʌm.taɪm	sometime
daɪr	dire
ˈeəpɔːt	airport
ˌəʊ.vəˈwɜːk	overwork
ˈpʌŋk.tju.əl	punctual
drəʊn	drone
nuːs	noose
pliːt	pleat
ˈblæŋ.kɪt	blanket
ˈdef.ər.əns	deference
ɪˈnept	inept
brɑːnz	bronze
həˈred.ɪ.tər.i	hereditary
dɪˈtɜːmɪnd	determined
faʊnd	found
ˌoʊ.vɚˈwɝːk	overwork
ˈem.bə.si	embassy
stɑːtʃ	starch
ˈdʒɔːn.ti	jaunty
səbˈdʒekt	subject
ˈkæb.ɪdʒ	cabbage
ˈpɪtʃ.ər	pitcher
fæŋ	fang
ˈdɒk.trɪn	doctrine
ˈwɪm.pər	whimper
kənˈviː.ni.əns	convenience
zɪp	zip
kəˈmɒd.ə.ti	commodity
ˈædvərtaɪz	advertise
ˈʌnˈbʌtn	unbutton
kəʊlt	colt
ˈbed.ɪŋ	bedding
ˌɪn.hɒsˈpɪt.ə.bl̩	inhospitable
mæs	mass
ˈriːsntli	recently
ˌjuːnɪˈvɜːsəti	university
ˈdaɪəɡræm	diagram
ɡaʊn	gown
ˈed.ɪ.fɪs	edifice
stænd	stand
ɪˈskɔːt	escort
veɪn	vain,vein,vane
ˈwer.i	wary
rɪˈbʌf	rebuff,rebuff
ɡræf	graph
wɜːk	work
ʃef	chef
stæb	stab
ˈtiːnˌeɪ.dʒər	teenager
baɪˈɑːlədʒi	biology
ˌɪntrəˈdʌkʃn	introduction
dʒest	jest
ˈbleɪm.ləs	blameless
ˈəʊvə(r)	over
ˈfʊtbɔːl	football
wɔːrf	wharf
tʌkˈsiː.dəʊ	tuxedo
ˈflæʃ.i	flashy
ˈproʊɡræm	program,programme
hɑːnt	haunt
ˈsaʊə(r)	sour
ˈtek.staɪl	textile
ˈmel.ən	melon
ˈneɪm.seɪk	namesake
ˌben.ɪˈfɪʃ.əl	beneficial
ˈʃʊɡə(r)	sugar
reɪt	rate
ˈfeɪθfl	faithful
ˈbɑː.bər	barber
əˈʃɔːr	ashore
ˌʌn.əˈveɪ.lə.bl̩	unavailable
roʊˈmæntɪk	romantic
ˈstɪk.ər	sticker
ˈʌðər	other
ɪmˈpɔːt	import
kɔːrn	corn
ˈhaʊs.waɪf	housewife
ɪmˈpjʊər	impure
praɪˈmerəli	primarily
ˈfʌz.i	fuzzy
ˌhɔːrəˈzɑːntl	horizontal
ˈkær.i.ər	carrier
ɪnˈθrəʊn	enthrone
ɡruː	grew
lɒk	lock
snɪr	sneer
əʊld	old
loʊˈkeɪʃn	location
dɪˈstræk.tɪd	distracted
tenθ	tenth
əˈtrəʊ.ʃəs	atrocious
ˈfaɪ.sti	feisty
ˈmeɪər	mayor
ˈsɪɡəret	cigarette
ˈbɔɪ.ɪʃ	boyish
ˈmiː.zl̩z	measles
ˈoʊ.dɚ	odour
kɑː	caw
ˈmænɪdʒər	manager
ˈiː.ɡoʊ	ego
feɪd	fade
vəˈsɪn.ə.t̬i	vicinity
ˈmɒm.i	mommy
ˈtraʊzəz	trousers
ˌnesəˈserəli	necessarily
səˈspɪʃəs	suspicious
rɪˈsiːd	recede
ˈhelθi	healthy
juːz	use
kəʊp	cope
ˈbæk.ʌp	backup
ˈræd.ɪ.kəl	radical
ˈɡɑː.səp	gossip
melt	melt
ɡɑːsp	gasp
oʊld	old
əˈvendʒ	avenge
daɪˈdʒes.tɪv	digestive
ˈɡroʊsəri	grocery
ˈɪm.plɪ.ment	implement
ɪnˈtelɪdʒənt	intelligent
kɔːps	corpse
ʌnˈbɔːn	unborn
ˌen.əˈdʒet.ɪk	energetic
rɪˈzʌlt	result
ˈriː.teɪl	retail
ˈem.ɪ.nəns	eminence
ɪnˈtriːt	entreat
ˈræb.ɪd	rabid
slaɪm	slime
ˈkɒnfɪdəns	confidence
ˈpɑːtnəʃɪp	partnership
ˈbæn.tər	banter
ɡleər	glare
əˈfɪʃl	official
ˈweə.haʊs	warehouse
ədˈvɑːnst	advanced
aʊns	ounce
ˈfɝːr	fir
ˈjuː.sɪdʒ	usage
ˈtʃɪz.əl	chisel
fəˈrəʊ.ʃəs	ferocious
ˈnjuːzpeɪpə(r)	newspaper
ˈpɪl.ər	pillar
ˈbrev.ɪ.ti	brevity
kəˈlekʃn	collection
ɪˈmiːdiətli	immediately
ˌsɪtʃuˈeɪʃn	situation
nəʊt	note
west	west
spiːd	speed
lɑːn	lawn
ˌæn.tɪˈkweə.ri.ən	antiquarian
njuːˈməʊ.ni.ə	pneumonia
ˈdaʊnwərd	downward
ˈpɜːsn	person
hɜːˈself	herself
tʃiːf	chief
ˈenəmi	enemy
ˈwɔːr.i.ɚ	warrior
hɪˈpɒk.rɪ.si	hypocrisy
ˈfɒl.tər	falter
ɪmˈprɪnt	imprint
pʊt	put
z	is
baɪt	bite
həˈraɪ.zən	horizon
ɪnˈkʌrɪdʒmənt	encouragement
ˈtruːθ.fəl	truthful
ˈbæt̬.ɚ	batter
ˈhəʊz.jə.ri	hosiery
mæn	man
ˈleɡ.i	leggy
rænt	rant
ˌblækˈkʌr.ənt	blackcurrant
doʊp	dope
doʊl	dole
sweɪd	suede
dʒiːnz	jeans
ˈmɜː.dər.ər	murderer
əˈstreɪ	astray
ˌdɪs.ɪmˈbɑːk	disembark
ˈzɪroʊ	zero
ˈʌn.də.pænts	underpants
ˈwɔː.feər	warfare
ɪˌmædʒɪˈneɪʃn	imagination
tʃeɪn	chain
piːk	peak,peek
ˈhɑː.stɪdʒ	hostage
əˈsoʊʃieɪt	associate
veɪɡ	vague
skwɑːʃ	squash
ˈθɪŋ.i	thingy
əˈpoʊz	oppose
ɪnˈfleɪt	inflate
ˈmʌs.ti	musty
vəˈlɒs.ɪ.ti	velocity
ˈhjuːmə(r)	humour
rɪˈlaɪə.bl̩	reliable
aɪˈdentɪfaɪ	identify
taɪt	tight
ˈbɒtl	bottle
draɪd	dried
stʌk	stuck
ˈstrʌktʃə(r)	structure
ʌnˈfɔːrtʃənətli	unfortunately
kɔːr	core
foʊk	folk
ˈven.dʒəns	vengeance
ˈfɑː.rə.weɪ	faraway
spaɪn	spine
jʊr	your
ˈfɪd.l̩	fiddle
əˈbæk	aback
ˈfræn.tʃaɪz	franchise
ˈɒpəzɪt	opposite
buːt	boot
ˈmɪs.trəs	mistress
ˈkrɒn.ɪk	chronic
kənˈtrəʊl	control
ˌɪn.təˈsteɪt	interstate
ˈlɑːb.stɚ	lobster
ˈmɪkstʃər	mixture
rɪˈfɔːrm	reform,reform
luːp	loop
ˈsætərdeɪ	Saturday
əˈlɑːm	alarm
əˈdʒʌst	adjust
ˌreɡjuˈleɪʃn	regulation
ˈmætʃɪŋ	matching
kəmˈpəʊz	compose
dɪˈluːʃən	dilution
ˈkænsə(r)	cancer
ˈkiː.pər	keeper
əˈweɪt	await
məˈnjʊər	manure
dɪˈsɑːm	disarm
ˈwɪd.əʊ	widow
wɜː(r)	were
ˈsɜːrtnli	certainly
ˈrezɪdənt	resident
ɪnˈfleɪm	inflame
ˈoʊ.pən.ɚ	opener
hər	her
ˈsɪŋə(r)	singer
dɪˈkler	declare
ˈkrɪtɪsɪzəm	criticism
swɒn	swan
streɪ	stray
kəˈnektɪd	connected
spaɪs	spice
ˈpepə(r)	pepper
ˈlɒk.ər	locker
ˌɪr.ɪˈprəʊ.tʃə.bl̩	irreproachable
leɪ	lay
ˈɪn.vən.tər.i	inventory
fleɪk	flake
ˈnɝː.tʃɚ	nurture
ˈkaɪndnəs	kindness
ədˈvɜːtɪsmənt	advertisement
stiːm	steam
ʌnˈduː	undo
dɪˈfaɪ.əns	defiance
prəˈpʌl.ʃən	propulsion
ˌriːˈfjʊəl	refuel
təˈdeɪ	today
ˈviː.təʊ	veto
mɪs	miss
ˈsɪriəsli	seriously
ɪkˈspensɪv	expensive
ˈleɪtɪst	latest
ˌɪn.əˈten.tɪv	inattentive
weə(r)	where,wear
ˈkɑːr.pɪn.t̬ɚ	carpenter
flɪntʃ	flinch
ˈdʒʌɡ.l̩	juggle
aɪˌden.tɪ.fɪˈkeɪ.ʃən	identification
hiːp	heap
rəʊ	row,roe
ˌstreɪtˈfɔː.wəd	straightforward
ˈdʒen.ə r.ə.laɪz	generalize
tɔɪl	toil
ˈpleɪə(r)	player
ɡlen	glen
ˈbɒt.ən.i	botany
teɪst	taste
ˈpenʃn	pension
ɑːlˈmaɪ.t̬i	almighty
ɪnˌtɜːprɪˈteɪʃn	interpretation
prəʊz	prose
əˈkʌs.təmd	accustomed
ˈbrəʊkən	broken
ˈel.dər	elder
ˈheə.kʌt	haircut
rɪˈkɔɪl	recoil
stjuːˈpen.dəs	stupendous
ˌkɒr.əˈleɪ.ʃən	correlation
ˈvɒljuːm	volume
mɑːrk	mark
bɪr	beer
ˈlɑːrdʒli	largely
təˈbæk.əʊ	tobacco
məʊ	mow
ˈsæt.jʊ.reɪt	saturate
trænsˈmɪt̬.ɚ	transmitter
ˈfɪɡə(r)	figure
ˈbeə.li	barely
pəˈreɪd	parade
əˈkjuːt	acute
rɪdʒ	ridge
fəˈnɒm.ɪ.nən	phenomenon
ˈsɒf.ən	soften
ˈkɑːm.per	compere
ˈvɪktɪm	victim
ˈnuːli	newly
ɪnˈsʌlt	insult
ˈkruːʃl	crucial
swiːd	Swede
ˈæp.ə.θi	apathy
pæst	past
ɪmˈpreɡ.nə.bl̩	impregnable
ˈbæl.kə.ni	balcony
ˌɒn.trə.prəˈnɜːr	entrepreneur
ˈkɒk.rəʊtʃ	cockroach
əˈbʌn.dəns	abundance
fɜːm	firm
ˈsʌðən	southern
ˈkɑː.nɪ.vəl	carnival
lɜːk	lurk
sesˈeɪ.ʃən	cessation
ɑː	awe
ˈswoʊlən	swollen
ˈɡeɪ.li	gaily
ˈsʌmtaɪmz	sometimes
ˈletə(r)	letter
ˈempaɪə(r)	empire
ˈɡræmər	grammar
ɪkˈsaɪtmənt	excitement
ˈwiː.zəl	weasel
ˈsɪstər	sister
ˌəʊ.vəˈbɔːd	overboard
θrɒŋ	throng
dɪˈskɜː.ti.əs	discourteous
ˈɪr.ɪ.tə.bl̩	irritable
spɑːk	spark
ˈmed.ɪk	medic
ˈæs.pɪ.rənt	aspirant
kənˈdʌk.tɪv	conductive
hæk	hack
ˈraɪt.fəl	rightful
kəˈdet	cadet
flɒp	flop
jɝːn	yearn
ˌek.wəˈnɪm.ɪ.ti	equanimity
fəˈɡɪv	forgive
əˈlɜː.dʒɪk	allergic
ˌrek.əˈlekt	recollect
hɜːz	hers
ˈbɑːn.faɪr	bonfire
ɪnˌkɒm.prɪˈhen.sɪ.bl̩	incomprehensible
ˈɑːɡjuː	argue
ʌnˈpæk	unpack
slaɪ	sly
ɪˈreɪ.di.eɪt	irradiate
kənˈfjuːzd	confused
ˈpred.ə.tər.i	predatory
dʌkt	duct
ˌpen.ɪˈten.ʃər.i	penitentiary
əˈrɪdʒənl	original
rɪˈspɒnsəbl	responsible
wenˈevə(r)	whenever
piːl	peel,peal
briːd	breed
ʃeɪm	shame
iˈmɜːdʒənsi	emergency
pʌmp	pump
snæk	snack
ɪnˈher.ɪt	inherit
ˈhaɪə.rɑː.ki	hierarchy
kənˈtɪnjuː	continue
ədˈventʃər	adventure
ˈsteɪtəs	status
pəˈdes.tri.ən	pedestrian
ˈdæz.l̩	dazzle
əˈkweɪn.tɪd	acquainted
bruːzd	bruised
sel	cell,sell
ˈmɑːr.kɚ	marker
ɔːˈɡæn.ɪk	organic
ˈmɜː.si	mercy
ˈʃæt̬.ɚ	shatter
ˈbɒn.faɪər	bonfire
hɑːrθ	hearth
ˈvæl.eɪ	valet
ɪmˈpɜː.sən.əl	impersonal
ˈempti	empty
ˌmɪsˈspel	misspell
ˈzɪɡ.zæɡ	zigzag
ɑːks	ox
səbˈskrɪp.ʃən	subscription
ˈdez.ɪɡ.neɪt	designate
ˈbɑː.di.ɡɑːrd	bodyguard
ˈɪn.t̬ɚ.steɪt	interstate
drentʃ	drench
ɪmˈped.ɪ.mənt	impediment
pəˈtɜː.nəl	paternal
ˈhæn.di	handy
ˌel.ɪˈmen.təl	elemental
ˈædvərtaɪzɪŋ	advertising
θɔːn	thorn
stəʊ	stow
ˈæk.ni	acne
moʊl	mole
ˈfɔːrmjələ	formula
ˈpeɪʃns	patience
əˈweɪ	away
det	debt
ˈɡæð.ər.ɪŋ	gathering
ˈfɜːr	fir
ˈəʊt.miːl	oatmeal
səˈpɑːs	surpass
ˈlɪm.bəʊ	limbo
ˈkʌmpəni	company
spɝː	spur
prəˈfesər	professor
ˈɑːtɪst	artist
juːst	used
ˈbæn.ər	banner
prəˈlɒŋ	prolong
ˈseprətli	separately
dɪn	din
spiːtʃ	speech
ˈplæt̬.ə.tuːd	platitude
əˈpres	oppress
ˈfɜː.taɪl	fertile
æbˈsteɪn	abstain
ˌmɪdˈsʌm.ər	midsummer
ˈhæn.səm	handsome
ˈreɪ.dɑːr	radar
ˈstæm.ər	stammer
ˈfæməli	family
ˌweərˈæz	whereas
ˈæŋkʃəs	anxious
əˈprəʊpriət	appropriate
duːk	duke
ˈbeɪ.lɪf	bailiff
ˈekstrə	extra
braɪb	bribe
ˈsniː.kɪŋ	sneaking
ˈlaɪ.nɪŋ	lining
ˈɪə.rə	era
kənˈtæm.ɪ.neɪt	contaminate
rɪˈspɑːnd	respond
əˈpærəntli	apparently
əˈpɑːl	appal
fɔːm	form
kɪk	kick
prɪˈvent	prevent
ɪˈtɜː.nɪ.ti	eternity
eɪs	ace
ˈɑː.lɪv	olive
ʌnˈtʃeɪndʒd	unchanged
ˈsɪn.juː	sinew
lʊk	look
rɪˈvʌl.ʃən	revulsion
ˈhæpɪli	happily
ˈentrəns	entrance
ˌʌnɪmˈplɔɪmənt	unemployment
ˈdɔː.mɪ.tər.i	dormitory
ˈiː.ɡəʊ.ɪ.zəm	egoism
ˈwɑː.loʊ	wallow
fɔːˈsiː	foresee
ˈlʌvər	lover
ˈɒk.ʌlt	occult
ˈsɜːrvənt	servant
ˈenvəloʊp	envelope
ˌsem.iˈkəʊ.lɒn	semicolon
verɪfɪˈkeɪʃn	verification
ˈeɪ.kər	acre
ˌprez.əˈveɪ.ʃən	preservation
dwɔːrf	dwarf
bɔːrn	born
dɪˈspær.ɪdʒ	disparage
tɒs	toss
ɪnˈvaɪ.tɪŋ	inviting
ˈɒp.ər.ə	opera
ˈmædʒɪk	magic
ˈperənt	parent
ʤiːn	jean
ˈɑːn.laɪn	online
ɪnˈtruːd	intrude
saɪ	sigh
ˌsɜː.kjʊˈleɪ.ʃən	circulation
ˈnəʊbədi	nobody
ˈbaɪ.əst	biased
nəˈses.ɪ.ti	necessity
prəˈtek.tər	protector
spɑːn	spawn
ˈses.ə.mi	sesame
səbˈsaɪd	subside
bɪˈhaɪnd	behind
ˈbʌtə(r)	butter
dɪˈlɪbərət	deliberate
ˈtaɪmteɪbl	timetable
ˈɒp.ʃən.əl	optional
ˈmem.ər.ə.bl̩	memorable
ɒd	odd
tʃest	chest
ʌnˈlɒk	unlock
droʊv	drove
ˈθɪri	theory
ˌkɒn.səˈleɪ.ʃən	consolation
ɔːlˈðoʊ	although
səʊ	so,sew,sow
sɪˈlekʃn	selection
ˈθɜːrəli	thoroughly
ˈsɪn.ə.mən	cinnamon
kɜːrl	curl
dɪˈsɪst	desist
ˈhjuːdʒ.li	hugely
ˈtraʊzərz	trousers
tɔːrdz	towards
drɔː(r)	drawer
ˈkæs.kɪt	casket
ˈkɑːntekst	context
drɪp	drip
ˈkjuː.pɪd	cupid
steɪ	stay
ˈred.ən	redden
ˈreɪ.di.ənt	radiant
bɔː(r)	bore
sləʊp	slope
ˈɡræd.ju.eɪ.tɪd	graduated
ˈdɪə.li	dearly
twɝːl	twirl
ˈbʌt.ə.flaɪ	butterfly
ˈkrɪm.zən	crimson
pɑːˈtɪʃ.ən	partition
ˈbeɪsɪkli	basically
blɑːt	blot
ˈmaɪnd.ləs	mindless,mindless
ˈhɑːrmləs	harmless
ˈprɒpəli	properly
ˈɡʌvərnər	governor
ˈdɪnər	dinner
ˈkuː.lər	cooler
ˈsɔːlti	salty
ˈven.ɪ.sən	venison
ˈbaɪ.ɡɒn	bygone
plæd	plaid
ˈkreɪzi	crazy
ɑːmd	armed
ədˈmaɪə(r)	admire
striːm	stream
ˈbeɪs.bɔːl	baseball
ˈmɪs.ti	misty
ˈkʌd.l̩	cuddle
ɪnˈfrɪndʒ.mənt	infringement
ˈdʊrɪŋ	during
ɪnˈsaɪt	incite
ɪnˈstrʌkt	instruct
stoʊv	stove
ˈkɜːrli	curly
dɪˈpraɪv	deprive
ˈhæn.dɪ.kæp	handicap
ˈmɪn.i	mini
rɪˈwɔːrd	reward
kwɪt	quit
ˈfæktri	factory
ɪmˈpəʊz	impose
ˈded.ɪ.keɪt	dedicate
ɪnˈsɜːrt	insert
wɪŋk	wink
ɪˈkwɪpt	equipped
haʊˈevə(r)	however
trænˈzæk.ʃən	transaction
ˈwaɪə.ləs	wireless
fəˈseɪk	forsake
ˈbrɪt.ɪʃ	British
ˌnɪəˈbaɪ	nearby
ˈkwɑːlɪfaɪ	qualify
ʃəd	should
ˈsoʊ.loʊ	solo
ˈfreɪm.wɜːk	framework
ˈmɪd.tɜːm	midterm
nɑːt	not,nought,knot
hɒlt	halt
sɔɪ	soy
ˈdek.ə.dəns	decadence
ˈɪr.ə	era
dʌm	dumb
ˈkɒm.paʊnd	compound
ˈruːɪnd	ruined
ˈʃɒpɪŋ	shopping
ˈoʊpnɪŋ	opening
stɝːn	stern
ler	lair
ˈaʊər	hour
ˈpɑː.tɪŋ	parting
ˈfɪl.θi	filthy
ˌʌn.dəˈlaɪn	underline
əˈpreɪz	appraise
ˈsaɪ.dər	cider
senˈseɪ.ʃən.əl	sensational
ˈhæm.stər	hamster
ˈvedʒtəbl	vegetable
dɪsˈɑːnɪst	dishonest
ˈɒr.ə.tər	orator
ˈbæŋ.kər	banker
ɪkˈstæt.ɪk	ecstatic
frɒθ	froth
əˈlaɪ.əns	alliance
ˈbɒðə(r)	bother
ˈfəʊtəʊ	photo
tɑːs	toss
ˈmædʒ.ə.sti	majesty
ˈpæʃ.ən.ət	passionate
ˈɒl.tə.neɪt	alternate
ˈtʃɪr.i	cheery
jɔːz	yours
ˈfɪʃɪŋ	fishing
ˈkɔː.lər	caller
fiːst	feast
ˈkɒb.lər	cobbler
kənˈkluːd	conclude
ˈɡʌvərnmənt	government
pəˈsjuː	pursue
liːs	lease
feɪnt	faint,feint
ˈdɪlɪdʒəns	diligence
smuːð	smooth
ɪnˈkred.ɪ.bl̩	incredible
ˈdiː.sən.si	decency
fɪəs	fierce
ˈfoʊl.dɚ	folder
ˈpɑːrti	party
wɒtʃ	watch
ˈfeə.ri	fairy
ˈkæθ.əl.ɪk	catholic
frɪsk	frisk
ʌnˈsɜːrtn	uncertain
kəmˈpetətɪv	competitive
bəʊθ	both
hiːv	heave
hjuːˈmɪl.i.eɪt	humiliate
ˈvɜː.sə.taɪl	versatile
ˈkɒl.ɪˌflaʊ.ər	cauliflower
ˈkwɔː.tə.bæk	quarterback
ˈblem.ɪʃ	blemish
əˈpɔːl	appal
ˈbʌbl	bubble
ɪnˈkrəʊtʃ	encroach
ˈbes.ti.əl	bestial
mæp	map
ˈdiː.kən	deacon
ˈfɔːr.dʒɚ.i	forgery
əˈwɔːrd	award
ˈkɑːr.t̬ɚ	carter
ˈkæn.dl̩	candle
frɒɡ	frog
ɪnˈkɜːrɪdʒmənt	encouragement
əbˈzɒlv	absolve
ˈæʃɪ	ashy
ˈmʌʃ.ruːm	mushroom
rɪˈlɪdʒən	religion
ˈpʌb.lɪ.ʃər	publisher
aɪˈdiːəl	ideal
ˈmentəli	mentally
vɪˈsɪn.ɪ.ti	vicinity
ʃrʌb	shrub
hæv	halve
rɪˈvɜːt	revert
əˈɡriː	agree
bɑːrn	barn
ˈʌʃ.ər	usher
ˈhɔː.ti	haughty
kɔːz	cause
ˈwiːkend	weekend
smæʃ	smash
ˈlætə(r)	latter
nɒtʃ	notch
ˈmær.ə.θən	marathon
dʒʌt	jut
ʌpˈset	upset
ˈpɒsəbli	possibly
ˈmʌsl	muscle
buːz	booze
ˈsəʊ.di.əm	sodium
ˈæɡ.rɪ.ɡət	aggregate
ˈkwaɪət	quiet
ɪnˈtaɪə(r)	entire
mɑːb	mob
ʃæk	shack
braʊ	brow
straɪp	stripe
lɔːst	lost
kənˈdʒest	congest
ɪmˈplɔɪ	employ
ˈraɪ.ət	riot
səˈsteɪn	sustain
ˈkʌt.lət	cutlet
ˈkʌntri	country
dɪˈskʌvər	discover
ˈræʃ.ən.əl.aɪz	rationalize
ˌhɒm.ɪˈsaɪ.dəl	homicidal
ˈθɔːt.ləs	thoughtless
skrætʃ	scratch
dɪˈsɔː.ri.ən.tɪd	disoriented
ˌoʊ.vɚˈhɪr	overhear
biːd	bead
ˈrɪv.ɪt	rivet
boʊst	boast
liˈeɪ.zɒn	liaison
ˈmɜː.dʒər	merger
ˈfoʊldɪŋ	folding
aɪ	I,eye
laɪk	like
ˈlæbrətɔːri	laboratory
ɔːˈdɪəl	ordeal
ˈtɜː.mɪ.neɪt	terminate
grætɪfɪˈkeɪʃn	gratification
əˈpɑːrtmənt	apartment
ˈmɑː.dʒuːl	module
ˈbækpæk	backpack
hɑːd	hard
ˈɑː.ster.ɪ.t̬i	austerity
miːk	meek
əˈdept	adept
ˈdʒʌstɪs	justice
ˌkɑːmpəˈtɪʃn	competition
ɑːrˈtɪstɪk	artistic
ˈdʌm.i	dummy
steɪk	stake,steak
ˈpætərn	pattern
fɪlm	film
ˈfreʃ.mən	freshman
mɪd	mid
ˈdʒʌdʒmənt	judgement
ˈher.ən	heron
stuːˈpɪd.ə.t̬i	stupidity
ˈpref.ər.ə.bli	preferably
rɪˈdɪkjələs	ridiculous
ˈsɪn.drəʊm	syndrome
pɑːn	pawn
klæŋ	clang
ˈpɑː.lər	parlour
kənˈkʌr.əns	concurrence
ˌdɪs.ɪnˈdʒen.ju.əs	disingenuous
hɑːl	haul
ˈer.es	heiress
ˌdɪs.bɪˈliːf	disbelief
dʒɜːm	germ
ɪmˈpɪə.ri.əl	imperial
ˈlæv.ə.tər.i	lavatory
ˈɔːfɪs	office
əˈweɪk	awake
ˈsɪn.ə.nɪm	synonym
kʌb	cub
ˈiːvn	even
ʃrɪmp	shrimp
ˈraɪ.fl̩	rifle
əˈbaʊnd	abound
mɑːr	mar
ˈraɪdɪŋ	riding
bleɪm	blame
ˈnʌr.ɪʃ	nourish
ɪmˈbɑːk	embark
ˈvɑː.lə.t̬əl	volatile
ˈbeɪ.sən	basin
ˈɡʌv.ən.əs	governess
huː	who
ˈɡɪd.i	giddy
ˈæp.tɪ.tjuːd	aptitude
ˈek.skə.veɪt	excavate
skeɪl	scale
ˈkraɪ.ɪŋ	crying
tætˈuː	tattoo
əˈprɒksɪmətli	approximately
fɑːrt	fart
ˈprɒf.ɪt	prophet
əˈten.dəns	attendance
ˈpʌblɪk	public
ˌsuː.pəˈfɪʃ.əl	superficial
sɒŋ	song
ˈləʊnli	lonely
ˈstʌmək	stomach
dɪˈleɪ	delay
ˈmiːdiəm	medium
bretθ	breadth
bækˈtɪriə	bacteria
hɪz	his
ˌɑːpərˈtuːnəti	opportunity
lɪft	lift
ˈerpɔːrt	airport
kəˈnek.tɪŋ	connecting
ˈbeə.rər	bearer
ˈsɪl.i.nəs	silliness
rɪˈkænt	recant
bɪˈtwiːn	between
ˈfaɪə.wɜːk	firework
ˈtæb.lɔɪd	tabloid
wuːp	whoop
ˌhæb.əˈdæʃ.ər.i	haberdashery
ˈhed.laɪt	headlight
təˈmeɪtoʊ	tomato
ˈpəʊɪm	poem
ɪnˈkaʊntər	encounter
ˈsev.ənθ	seventh
ˈklæs.i	classy
stuːl	stool
ˈtem.pər.əl	temporal
ˈneɪbər	neighbour
ˈpæs.ɪ.faɪ	pacify
fərˈseɪk	forsake
sjuːˈpɪəriə(r)	superior
səˈveɪ.ləns	surveillance
ɪnˈkrɪm.ɪ.neɪt	incriminate
ˈɡɜː.ɡl̩	gurgle
bɑːlk	balk
əˈfekt	affect
ˌhɪəˈbaɪ	hereby
ˈkrʌm.i	crummy
ɪˈleɪ.tɪd	elated
ɪɡˈzem.plɪ.faɪ	exemplify
feɪn	feign
ˈpleɪn.tɪf	plaintiff
ʃaʊt	shout
plæn	plan
ʃɪp	ship
dɪsˈɡʌstɪŋ	disgusting
ˈbæl.ənst	balanced
ˌəʊ.vəˈres.tɪ.meɪt	overestimate
ˈfær.ən.haɪt	Fahrenheit
fɜːrst	first
tɪnt	tint
ˈkæv.ɪ.ti	cavity
flɑːp	flop
ɡræm	gram
ˈdɪfɪkəlt	difficult
wɒʃ	wash
ˈtɔɪlət	toilet
bɪˈloʊ	below
ˈɒp.ər.eɪ.tər	operator
poʊk	poke
ˈsnæp.i	snappy
kraɪm	crime
ˈmɑː.ʃi	marshy
ˌəʊ.vəˈtɜːn	overturn
ˈfem.ɪ.nɪn	feminine
ˈdes.pɒt	despot
nɒb	knob
ɑːmˈnɪp.ə.t̬ənt	omnipotent
end	end
kəmˈper	compare
kəˈneə.ri	canary
slɒb	slob
brɒθ	broth
ˈbeɡ.ə.li	beggarly
prɑːm	prom
pɪt	pit
ˈliː.θəl	lethal
mjuːz	muse
ɪˈnæd.ɪ.kwət	inadequate
ˈoʊpən	open
daɪˈvɜːs	diverse,diverse
əˈʃʊə(r)	assure
ˈaʊt.lʊk	outlook
eksˈheɪl	exhale
ˈmɪs.l̩.təʊ	mistletoe
ˌdɪs.əˈvaʊ	disavow
ˈem.ɪ.nənt	eminent
ˈnaɪðər	neither
ˈvɜːrtɪkl	vertical
reɪd	raid
ˌriː.kənˈstrʌkt	reconstruct
ɪˈmɪt	emit
hɪndʒ	hinge
nʊk	nook
jet	yet
ˈɑː.dənt	ardent
baʊəl	bowel
ɡrænd	grand
dɪˈvɔːrs	divorce
plænt	plant
ˈeseɪ	essay
ˌrevəˈluːʃn	revolution
ʃed	shed
ˈswɑːloʊ	swallow
kraʊn	crown
tɜːn	turn
ˈɡlæs.i.ər	glacier
pɪˈdʒɑː.məz	pajamas
æpt	apt
ˈkeɪ.tər	cater
ˈtreɪ.lər	trailer
pleɪn	plane,plain
pəˈtɪkjələ(r)	particular
rɪˈsepʃn	reception
əˈbrɔːd	abroad
ˈvɜː.tju.əl	virtual
ˈɔːfər	offer
ɪnˈdʒɔɪəbl	enjoyable
həʊm	home
ˈɪn.dɪ.keɪ.tər	indicator
feɪl	fail
ˈmɑː.bl̩	marble
ˈpen.ɪ.treɪt	penetrate
plʌm	plum,plumb
ˈpiː.nəl	penal
ɡeɪn	gain
ˈkɑːnsəkwens	consequence
nɒd	nod
ˈtrɑːpɪkl	tropical
ˌʌnəkˈseptəbl	unacceptable
njuːz	news
əˈwaɪl	awhile
dɪˈstrækt	distract
ˌkred.əˈbɪl.ɪ.ti	credibility
ˈsaɪ.fər	cipher
ˈdɪt.əʊ	ditto
ˈstʌf.i	stuffy
əˈfləʊt	afloat
miːn	mean
ɪˈnek.sər.ə.bl̩	inexorable
ˈwʌndə(r)	wonder
ˈsməʊkɪŋ	smoking
kɑːrt	cart
ˈfel.ən	felon
kəʊn	cone
ɑːn	on
sɒlv	solve
ˈsuː.ɪ.saɪd	suicide
daɪˈdʒest	digest
dɪsˈdeɪn	disdain
ˈdɪfrənt	different
ˈɡʊd.nəs	goodness
paɪn	pine
dɪˈpɒzɪt	deposit
stuː	stew
ˌreɪ.di.əʊˈæk.tɪv	radioactive
spʌn	spun
wɔːk	walk
ˈɡlɔː.ri.əs	glorious
vɑːlˈkeɪ.noʊ	volcano
ˈhiː.tɪŋ	heating
ˈsen.sjʊəl	sensual
ɪmˈbɑː.ɡəʊ	embargo
daɪˈluːt	dilute
əˈtrækʃn	attraction
ˈpəʊ.tən.si	potency
ˌpɪr.iˈɑː.dɪk	periodic
ˈɪŋkriːs	increase
ˈpraɪməri	primary
ˈkæm.pəs	campus
fəˈbɪd	forbid
ˈklʌt.ər	clutter
səˈpoʊz	suppose
ˈkɑː.mɪt	comet
leər	lair
sɪɡˈnɪf.ɪ.kəns	significance
kroʊˈʃeɪ	crochet
ˈred.i.nəs	readiness
fɪr	fear
səˈspɪʃn	suspicion
ˈblæd.ər	bladder
ˈiː.tər	eater
ˈflɒr.ɪst	florist
trɪp	trip
klɪŋ	cling
ədˌmɪn.ɪˈstreɪ.ʃən	administration
ˌvɪz.ɪˈteɪ.ʃən	visitation
ˌɑːtɪˈfɪʃl	artificial
ˈɡreɪ.vi	gravy
poʊtʃ	poach
ˌriːˈprɪnt	reprint
rɪˈmɪt.əns	remittance
rɪŋ	ring,wring
əˈpreɪ.zəl	appraisal
əˈkɪn	akin
ɪnˈtaɪəli	entirely
əbˈsɔːrb	absorb
ɡəʊst	ghost
noʊn	known
ˈbʊk.ɪŋ	booking
ˈfrɪv.əl.əs	frivolous
ˈpæt.rə.nɪdʒ	patronage
ˈæktʃuəli	actually
ˈsləʊli	slowly
sʌk	suck
næt	gnat
ˈkɑːm.pə.t̬ənt	competent
ˈtʌk.ər	tucker
ɪɡˈzækt	exact
ˈmaɪnər	minor
ˈwɪk.ɪd	wicked
dɪˈtɜːrmɪn	determine
əˈpren.tɪs	apprentice
ˈmeɪ.hem	mayhem
ˈʌd.ər	udder
dɪˈskwaɪət	disquiet
əˈtræktɪv	attractive
dræŋk	drank
ˈdiːteɪld	detailed
ˈmeɪ.ə.neɪz	mayonnaise
dɪˈskreʃ.ən	discretion
ˌʌl.tɪˈmeɪ.təm	ultimatum
ˈven.tɪ.leɪ.tər	ventilator
ˈelɪveɪtər	elevator
prer	prayer
ˈdʒænjuəri	January
kəʊˈɪn.sɪ.dənt	coincident
snɪtʃ	snitch
rɪˈlent.ləs	relentless
dɔːb	daub
əˈleɪ	allay
ˌdiː.kəmˈpəʊz	decompose
peɪnt	paint
ˈpraɪvət	private
ˈwɔː.drəʊb	wardrobe
ɪkˈspɪəriəns	experience
ˈtrɪp.l̩	triple
ˈbæɡɪdʒ	baggage
əˈmjuːz	amuse
ˈsɪk.l̩	sickle
rəʊd	road
haɪˈpɒθ.ə.sɪs	hypothesis
ˌwaɪdˈspred	widespread
æmˈbæs.ə.dər	ambassador
ˌʌn.dəˈsteɪt.mənt	understatement
ˈsʌnˌɡlæs.ɪz	sunglasses
ɪnˈfɔːrml	informal
ˈbæθruːm	bathroom
bæŋ	bang
ˈsɪzərz	scissors
ˌkɑːnsnˈtreɪʃn	concentration
ˌsuː.pəˈvɪʒ.ən	supervision
ˈher.ɪ.tɪdʒ	heritage
səbˈdjuː	subdue
kɪŋ	king
ˌdɪs.əˈbɪl.ɪ.ti	disability
ˈhʌs.l̩	hustle
lʌntʃ	lunch
dʒɒb	job
pəˈmɪʃn	permission
ˈbɪskɪt	biscuit
dɪˈvɔːrst	divorced
prəˈməʊʃn	promotion
ˈsʌbstəns	substance,substance
toʊld	told
əˈlaɪn.mənt	alignment
snɑːl	snarl
luːt	loot
ɪˈstæblɪʃ	establish
təˈmɒrəʊ	tomorrow
sleɪv	slave
dʒuː	Jew
ɪˈnjuː.mər.ə.bl̩	innumerable
ðeə(r)	there,their
mɑːrtʃ	march,March
ˈhæbɪt	habit
ˈpɑːtli	partly
sɒlt	salt
stɪŋk	stink
wʊd	would,wood
ˈplæs.ɪd	placid
frʌsˈtreɪ.ʃən	frustration
ˈɡɒdˌmʌð.ər	godmother
kəˈmɪt.ɪd	committed
dɪsˈmɪs	dismiss
kəˈmɑːnd	command
ˈdwel.ɪŋ	dwelling
deɪz	daze
rɪˈzentmənt	resentment
dɪˈfens	defence
ˈprɒmɪs	promise
piˈænoʊ	piano
kɪt	kit
ˈhænd.bæɡ	handbag
hɒp	hop
ˈθæŋk.fəl	thankful
əkˈsep.təns	acceptance
ˈdeə.rɪŋ	daring
ˈdʒuːniə(r)	junior
ˈkerləs	careless
ˈmærɪdʒ	marriage
driːm	dream
freʃ	fresh
ˈsloʊli	slowly
ˌkærəktəˈrɪstɪk	characteristic
ðeəz	theirs
ˈæd.ə.mənt	adamant
men	men
ˈɡræn.ər.i	granary
ˈdʒenjuɪnli	genuinely
ˈdeɪn.ti	dainty
ˈres.l̩	wrestle
əˈnɔɪ	annoy
ˈret̬.ən.uː	retinue
kɑːr	car
prəˈsiːdʒər	procedure
ˈbɑːrɡən	bargain
ˈmeʒərmənt	measurement
ˈlʌk.ʃər.i	luxury
slɑːt	slot
ˈɔːθə(r)	author
ʃɔːl	shawl
ˈɑːrtɪkl	article
ˈrɑː.skəl	rascal
ɪmˈpɑː.sə.bl̩	impassable
ˈvæl.i.ənt	valiant
duːm	doom
ˈkærəktər	character
ˈlɪn.ɪn	linen
fəˈtɑːɡrəfi	photography
eɪk	ache
ˈrəʊz.bʌd	rosebud
pəˈlɪtɪkli	politically
dʒɑːb	job
dræft	draft,draught
ˈɡlæm.ər	glamour
ɪkˈskɜː.ʃən	excursion
prəˈvɪʒ.ən	provision
dɪˈpɑːtmənt	department
ˈtʃəʊ.zən	chosen
ˈdraɪv.weɪ	driveway
ˈmɒn.ə.stri	monastery
wɔːp	warp
skuːt	scoot
klæs	class
ˈɡlʌt.ən	glutton
prɔːn	prawn
ɪˈnækt	enact
rɪˈfrɪdʒəreɪtər	refrigerator
ˈoʊ.vɚ.li	overly
kweɪnt	quaint
kəˈlek.tər	collector
pəˈliːsmən	policeman
ˈæbsənt	absent
riːp	reap
klʌb	club
ˈbiː.tən	beaten
bɜːrnt	burnt
pæt	pat
fraʊn	frown
prəˈpraɪə.tər.i	proprietary
ˈæk.ə.leɪd	accolade
dɔːr	door
ˈnaɪ.lɒn	nylon
ˈnoʊ.t̬ɚ.i	notary
ˈreɡjələ(r)	regular
prəˈməʊt	promote
ʌnˈlʌki	unlucky
ˌmʌl.tiˈkʌl.tʃər.əl	multicultural
ˈrʊk.i	rookie
bɪˈləʊ	below
eɪ	a
iːt	eat
ʃeəd	shared
ˌkɒnvəˈseɪʃn	conversation
ˈnɪk.neɪm	nickname
ˌhoʊ.moʊˈsek.ʃu.əl	homosexual
ˈdiː.vi.eɪt	deviate
ˈsæŋk.tʃʊə.ri	sanctuary
tɑːp	top
ˈefət	effort
ˈpeɪ.pə.wɜːk	paperwork
ˈbreɪ.slət	bracelet
ˈkæm.ə.flɑːʒ	camouflage
keɪn	cane
ˈeə.ri	airy
ɪˈkwɒl.ɪ.ti	equality
kɔːst	cost
dʒʌŋk	junk
ˈdɪsəplɪn	discipline
kɜːst	cursed
ˈpɑː.pi	poppy
dɪˈspleɪs	displace
pʌlp	pulp
ˈmɪrə(r)	mirror
bləʊt	bloat
sɪŋk	sink
njʊəˈrɒt.ɪk	neurotic
ˈaŋɡrɪli	angrily
ˌnɪrˈbaɪ	nearby
ˈdɪskaʊnt	discount
mjuːl	mule
ˈɡlɪt.ər	glitter
ˈpɑːrtli	partly
meɪz	maze
slɪt	slit
ˈdiː.vi.əs	devious
ðəʊ	though
dʌŋ	dung
nɜːrs	nurse
ˈɡær.ɪ.sən	garrison
ˈhænd.kʌf	handcuff
hɔːnt	haunt
sʌlk	sulk
ɪkˈsploʊd	explode
ˈnəʊ.zi	nosy
ˈstɪər.ɔɪd	steroid
slæʃ	slash
ˈædʒ.ɪ.teɪt	agitate
ˈwɒr.ənt	warrant
ˈfɒl.i	folly
ˈpʌblɪʃ	publish
reɪˈʒiːm	regime
ˌdɪs.rɪˈspekt	disrespect
əˈpoʊnənt	opponent
ˈbæŋ.kɪŋ	banking
ˈlɒn.ʒər.i	lingerie
əˈtend	attend
spel	spell
ˌpɑːləˈtɪʃn	politician
ˈtes.tɪ.faɪ	testify
raɪp	ripe
əˈsent	assent
ˈterəbl	terrible
ˈfebruəri	February
vəˈnɪl.ə	vanilla
ɡrɔɪn	groin
bɑːn	barn
kɔːn	corn
dɪˈzɑː.strəs	disastrous
ˈsæt.aɪər	satire
əˈsenʃn	ascension
kræʃ	crash
ˈnoʊwer	nowhere
ˈmɪrər	mirror
ˈpɪk.ʌp	pickup
ˈswɪm.suːt	swimsuit
klentʃ	clench
ˈæŋɡri	angry
ɪl	ill
ɪnˈtɒk.sɪ.keɪt	intoxicate
haɪv	hive
bɑːsk	bask
ˈneɡətɪv	negative
kweɪk	quake
ˈbed.rɪ.dən	bedridden
ˈlektʃə(r)	lecture
ˈʌvn	oven
ˈmuː.di	moody
ˈbɑː.nɪt	bonnet
ˈpɔːt.li	portly
ˌmæɡəˈziːn	magazine
skriːn	screen
ˈlæn.dɪŋ	landing
ˈpɒlɪʃ	polish
ˈpɔː.tər	porter
ˈdɪn.ə.sti	dynasty
stoʊ	stow
ˈneɪbə(r)	neighbour
ˈnɜː.sər.i	nursery
ˈpeə.rən.tɪŋ	parenting
əˌsæs.ɪˈneɪ.ʃən	assassination
ˌdek.ləˈreɪ.ʃən	declaration
ˈsəʊ.ʃəl.i	socially
ˌmɔː.zəˈliː.əm	mausoleum
əˈkleɪm	acclaim
ˈflɪm.zi	flimsy
tɑːt	taught,tart
brɪdʒ	bridge
ˈeɡ.zaɪl	exile
ˈfjuːtʃər	future
əkˈseptəbl	acceptable
dəʊ	dough
əbˈskjʊər	obscure
ˈkæn.və.sər	canvass
ˌrez.ərˈek.ʃən	resurrection
ˈæn.ti.rʊm	anteroom
ˈðerfɔːr	therefore
ˈkaʊ.ɚd	coward
ˈθɜːsti	thirsty
ɡroʊθ	growth
bæn	ban
ˈreɪ.lɪŋ	railing
ˈfɔːrtʃən	fortune
ɪˈventʃuəli	eventually
ˈsepəreɪtɪd	separated
ˈmaɪ.lɪdʒ	mileage
ˈwɜːri	worry
ˈrelətɪvli	relatively
ɪmˈbæŋk.mənt	embankment
ɪnˈdʒekt	inject
ˈstʌt̬.ɚ	stutter
æbˈhɔːr	abhor
lɑːdʒ	large,lodge
kəˈmɑːn.dər	commander
ˈɪn.tɪ.ɡrəl	integral
klaʊd	cloud
kənˌsɪdəˈreɪʃn	consideration
ˈkɑːntækt	contact
beɪ	bay
drɑːn	drawn
baʊns	bounce
ˈfloʊ.t̬ɪŋ	floating
roʊst	roast
kəmˈpiːt	compete
ɝːb	herb
frentʃ	French
ˈskruː.pjʊ.ləs	scrupulous
əˈfen.dər	offender
ˈslɔː.tər	slaughter
ˈmɪlətri	military
baʊnd	bound
əˈtʃiːv	achieve
ɪnˈtɜːrnl	internal
swɑːn	swan
ˈfræɡ.mənt	fragment
ˈbʌr.ə	borough
mʌm	mum
pɒmp	pomp
skɑːf	scarf
ˈjɪə.li	yearly
ˈkrɪs.ən.ɪŋ	christening
ˈsoʊɪŋ	sewing
skwɒd	squad
ˈtʃælɪndʒ	challenge
ˈniː.di	needy
dɪˈstrʌst	distrust
rɪˈsɪp.rə.kəl	reciprocal
ˈfeɪljər	failure
rɔː	raw
dʒem	gem
mɑːst	mast
ˈsɜːrtn	certain
ˈhəʊl.dɪŋ	holding
prəˈkjʊər	procure
ˈzen.ɪθ	zenith
weɪdʒ	wage
əˈrɪdʒənəli	originally
ˈnjuː.mə.rəl	numeral
ˈtrɪb.juːt	tribute
flɜːˈteɪ.ʃəs	flirtatious
ˈkwestʃən	question
ɪnˈtɜːnl	internal
ˈsɪzəz	scissors
ˈprɒv.ɜːb	proverb
ˈflɔː.rəl	floral
ˈhəʊp.fəl.i	hopefully
ˈskæt.ər	scatter
bɪˈɡɪn.ər	beginner
ˈpeɪv.mənt	pavement
ɪkˈstensɪv	extensive
æbˈʤekʃn	abjection
ˈleɪt.li	lately
ˌækəˈdemɪk	academic
ˈdʒɒk.i	jockey
ˈplaɪ.wʊd	plywood
ˌəʊ.vəˈsliːp	oversleep
piˈænəʊ	piano
ˈkaʊ.ər	cower
ˈæp.lɪ.kənt	applicant
ˌnəʊ.tərˈaɪ.ə.ti	notoriety
ˈɪntrəstɪd	interested
ˈdɒm.ɪ.nənt	dominant
kəˈlaɪd	collide
hɪr	here,hear
ˈfrɪk.ʃən	friction
riːf	reef
bræɡ	brag
ˈprɪntər	printer
ˈskɒl.ər	scholar
fʊt	foot
ˈwɪndəʊ	window
ˈmɪz.ər.i	misery
ˈɡɑːrbɪdʒ	garbage
ˈbɜː.dən	burden
roʊb	robe
pɑːst	past
ˈkəʊ.lɒn	colon
ˈkæʃ.mɪər	cashmere
kəˈtæs.trə.fi	catastrophe
ˈem.jʊ.leɪt	emulate
kənˈspɪk.ju.əs	conspicuous
ˈraɪ.zɪŋ	rising
dʒɪm	gym
ˈkæt̬.ɚ.pɪl.ɚ	caterpillar
ˈkwɒn.dri	quandary
suːt	suit
ˈveəri	vary
ˌəʊ.vəˈsiːz	overseas
ɪkˈstrɔːdnri	extraordinary
əˈfɜːm	affirm
ˈbɑːθ.tʌb	bathtub
flɔː(r)	floor
ænˈtɪsɪpeɪt	anticipate
əˈreɪ	array
sənt	saint
ˈklɪrli	clearly
ˈləʊkl	local
ˈmeɪn.tɪ.nəns	maintenance
ləʊˈkeɪt	locate
brɑːs	brass
ˈber.i.əl	burial
hɔː	haw
ˈsʌm.pleɪs	someplace
skwɑːd	squad
ˈkɒntrɪbjuːt	contribute
ˈven.ə.məs	venomous
ɪnˈter.ə.ɡeɪt	interrogate
ˈʃɪn.dɪɡ	shindig
ˈfɜːrnɪtʃər	furniture
wuːnd	wound
ˌtrænspɔːrˈteɪʃn	transportation
ˈmæt.rɪ.mə.ni	matrimony
ˈnɔːrml	normal
beɡ	beg
ˈrelətɪv	relative
ˈkɑːtn	cotton
dɪˈfiːt	defeat
ˈkʌm.pəs	compass
ˈpoʊ.lɚ	polar
fəˈtɪl.ɪ.ti	fertility
ˈætɪtjuːd	attitude
məˈtɪəriəl	material
ˈməʊtəsaɪkl	motorcycle
ˈkɑː.vər	carver
ˈkwɪkli	quickly
ˈklæs.ɪ.faɪd	classified
dɪˈstrɔːt	distraught
fʊlˈfɪld	fulfilled
fuːd	food
siːt	seat
ˌiː.kəˈnɒm.ɪks	economics
ˌriː.əˈreɪndʒ	rearrange
mɪdʒ	midge
səˈmaʊnt	surmount
dɪˈnəʊt	denote
ˈmuːvi	movie
ˈvɪʒ.u.əl	visual
ˈrɑː.kɪt	rocket
ˈlɒn.dʒɪ.tjuːd	longitude
ˌmænjuˈfæktʃər	manufacture
ˌæn.ɪˈmɒs.ɪ.ti	animosity
ænˈeks	annex
səˈbɜː.bən	suburban
təˈrɪf.ɪk	terrific
bɪˈhæf	behalf
ˈruː.bi	ruby
ˌpɜː.sɪˈvɪə.rəns	perseverance
ˈpæt.rən.aɪz	patronize
blɜːr	blur
ˈtʊərɪst	tourist
ˈhəʊm.ləs	homeless
dɪˈpreʃ.ən	depression
dɪˈfek.tɪv	defective
ˈsɑː.ləm	solemn
ˈɪm.pʌls	impulse
ˈtuːθ.brʌʃ	toothbrush
mɔːɡ	morgue
rɪˈtɜːn	return
ˈendɪŋ	ending
ˈweɪ.trəs	waitress
lɪp	lip
ˈkɑː.mɪk	comic
ˈbreɪkˌʌp	breakup
ˈɪndʒəri	injury
ˌɑːftəˈnuːn	afternoon
puːl	pool
ˌmɪl.jəˈneər	millionaire
ˈen.vi.ə.bl̩	enviable
spiːk	speak
ˈfɔːrmər	former
ˌpɜː.sənˈel	personnel
diːd	deed
ˈɑːntə	onto
ˌkɔː.pərˈeɪ.ʃən	corporation
tɜːf	turf
ˈklɪp.ər	clipper
ˈɡrænmʌðər	grandmother
sneɪk	snake
ˈvɜːrtʃuəli	virtually
ˈbles.ɪŋ	blessing
ˈsem.ɪ.nɑːr	seminar
pʊl	pull
ˈvaɪ.pər	viper
ˈtʃænd.lɚ	chandler
bræʃ	brash
sjuːt	suit
wɪˈðɪn	within
kæmp	camp
pʌbˈlɪsəti	publicity
ˈflæʃ.laɪt	flashlight
ˈkɑː.di.æk	cardiac
meɪk	make
seɪl	sail,sale
səˈpɔːrtər	supporter
ˈpʊʃ.i	pushy
ˈbriː.ðər	breather
rɪˈtɔːt	retort
faɪl	file
ˈsʌmwʌt	somewhat
kənˈsaɪn.mənt	consignment
ˈmeɪl.bɒks	mailbox
əˈfer	affair
bɪˈjɒnd	beyond
ˈsiː.fuːd	seafood
kloʊð	clothe
pɪtʃ	pitch
ˈtreʒ.ər	treasure
ˈməʊ.mən.tər.i	momentary
brəʊtʃ	brooch
ˈtɜː.mɔɪl	turmoil
ˈprəʊ.faɪl	profile
mɪə(r)	mere
kənˈsɪdərəbl	considerable
ˈtɜː.bən	turban
əˈnæt.ə.mi	anatomy
fuːl	fool
ˈdel.juːdʒ	deluge
əˈtrɒs.ɪ.ti	atrocity
ˈfɪt.fəl	fitful
kəˈməʊ.ʃən	commotion
tiːθ	teeth
ˈkʌvəd	covered
ˈpɜːmənənt	permanent
ˈrɒb.ər.i	robbery
ˈruːθ.ləs	ruthless
ˈlet.ɪs	lettuce
kɑːrv	carve
ˈeɪbl	able
krʌtʃ	crutch
ˈrer.ə.t̬i	rarity
ɪmˈper.ə.tɪv	imperative
ˈtrɪk.l̩	trickle
ˈfriːdəm	freedom
ˈmɪrli	merely
ˈsɜː.pənt	serpent
riːθ	wreath
riːd	read,reed,reed
ˌpreznˈteɪʃn	presentation
feɪz	phase
blɒt	blot
ɪmˈplɑːnt	implant
heɪt	hate
pen	pen
ˌɪndɪˈvɪdʒuəl	individual
lefˈten.ənt	lieutenant
ˈrem.nənt	remnant
ˈtʃɑː.tər	charter
ɪkˈses	excess
rɑːk	rock
ˈflæb.i	flabby
ˈnæp.kɪn	napkin
ˌek.spəˈdɪʃ.ən	expedition
kɜːl	curl
mæsˈkɑː.rə	mascara
ˌɪn.təˈrækt	interact
jɔːn	yawn
dɪˈpreɪv	deprave
lɪv	live
dɪˈzæstər	disaster
ˈreɡjələrli	regularly
ʃʌv	shove
ˈruː.lɪŋ	ruling
rəʊɡ	rogue
ˈkʊk.uː	cuckoo
ˈɜːk.səm	irksome
oʊn	own
hɔːrs	horse,hoarse
kəˈləʊn	cologne
ˈrefrəns	reference
ˈwɒl.əʊ	wallow
ˈwɪl.əʊ	willow
deθ	death
ˈev.ə.ɡriːn	evergreen
ˈstrɪktli	strictly
bʌlb	bulb
ˈbɑːr.t̬ɚ	barter
fler	flare
bʊk	book
fɔːrk	fork
ˈdɑːnsə(r)	dancer
ɪnˈteɡ.rə.ti	integrity
ˈfɑː.stɚ	foster
stɪə(r)	steer
əkˈnɒlɪdʒ	acknowledge
wɪˈtʃev.ər	whichever
bɪəd	beard
dɪˈfeɪs	deface
ˈɒb.djʊ.rət	obdurate
ˌres.pɪˈreɪ.ʃən	respiration
ˈɡrædʒ.u.ət	graduate
ˈpɔː.ʃən	portion
kənˈsɪs.tənt	consistent
ˈsləʊ.ɡən	slogan
sərˈpraɪzɪŋ	surprising
ˈæl.tɪ.tjuːd	altitude
kənˈteɪnər	container
ˈɑː.tʃə.ri	archery
ˈpɒzətɪv	positive
ˈdɜːrti	dirty
ˈθɪəri	theory
ˈstrʌɡl	struggle
ɪmˈpruːvmənt	improvement
paɪnt	pint
luːz	lose
plʌk	pluck
aʊtˈmæʧ	outmatch
ˈbɝː.ɡlɚ	burglar
prəˈfɪʃ.ənt	proficient
ˈbreɪk.θruː	breakthrough
spəˈɡet.i	spaghetti
əˈɡriːmənt	agreement
spɒnˈteɪ.ni.əs	spontaneous
plæŋk	plank
ˌhɑː.spɪˈtæl.ə.t̬i	hospitality
ˈbuː.lə.vɑːd	boulevard
ˈbæɡ.i	baggy
əˈnʌðər	another
ˈmæɡ.nɪ.tjuːd	magnitude
ˈfæð.əm	fathom
ɪnˈskraɪb	inscribe
ˈnɒnsns	nonsense
əˈkwaɪə(r)	acquire
ˈæbsəns	absence
ˈhelp.ləs	helpless
ˈmɝː.dʒɚ	merger
ˈmɪl.ɪ.tənt	militant
əˈkɒm.ə.deɪ.tɪŋ	accommodating
bʌs	bus
brest	breast
ˈkɒn.trə.ri	contrary
ˌsæt.ɪsˈfæk.tər.i	satisfactory
ˈslɪp.ər.i	slippery
straɪd	stride
əˈbaɪd	abide
ˈfɔː.rɑːm	forearm
θɪn	thin
ˈʃɒpˌlɪf.tɪŋ	shoplifting
dɪˈsaɪ.sɪv	decisive
ˈæl.i	alley
fəˈlɒsəfi	philosophy
ˌʌndəˈstændɪŋ	understanding
ˈdʒes.tʃər	gesture
θɜːst	thirst
flɪŋ	fling
ˈlaɪtli	lightly
ˈmoʊ.t̬ɪv	motive
raɪˈnɒs.ər.əs	rhinoceros
ˈswɔː.ði	swarthy
ˈfʌn.dɪŋ	funding
ˈsaɪlənt	silent
kræft	craft
ˈpeŋ.ɡwɪn	penguin
əˈmeɪz	amaze
ˈɒkjupaɪ	occupy
ɪŋk	ink
fləʊt	float
ˈsædli	sadly
snɪf	sniff
səbˈsɪst	subsist
ˈθɪŋkɪŋ	thinking
nɪr	near
ˌɑːpəˈreɪʃn	operation
ˈkɑːsl	castle
ˈbær.əl	barrel
məˈriːn	marine
ˌdem.əˈkræt.ɪk	democratic
wer	where,wear
ˈspaɪə.rəl	spiral
dɪˈbɔːtʃ	debauch
læns	lance
rəʊˈteɪt	rotate
ˈsaɪləns	silence
ˈriːznəbl	reasonable
ˈskʌlp.tər	sculptor
ˈpʌd.l̩	puddle
ðəm	them
ˈəʊ.dər	odour
ɡɑːz	gauze
ˈsɪl.ə.bəs	syllabus
ˈen.i.taɪm	anytime
ʃɔːrts	shorts
hjuːˈmɪd.ɪ.ti	humidity
ˈpes.ki	pesky
ˈpreʃər	pressure
kənˈtɪn.dʒənt	contingent
ˈtuː.t̬ɚ	tutor
bɔːld	bald
ˈveə.ri.ə.bl̩	variable
ˈæŋ.kər	anchor
kənˈviːniənt	convenient
kæst	cast
ˌɔː.θər.aɪˈzeɪ.ʃən	authorization
ˈkləʊs.li	closely
fɜːrm	firm
ˌʌn.dəˈkʌv.ər	undercover
ˈkɑː.pɪn.tər	carpenter
ˈfɪə.fəl	fearful
ˈɑː.di.oʊ	audio
ɪnˈlɪst	enlist
əˈbɔːr	abhor
ˈʌndə(r)	under
bəˈzɑːr	bazaar
ˈwɑː.t̬ɚ.i	watery
vælv	valve
bruˈnet	brunette
ɪˈnæm.əl	enamel
ˈpɒl.ə.ti	polity
ˈkɒn.sjʊ.lət	consulate
truːs	truce
ˈɑːm.pɪt	armpit
biːtʃ	beach,beech
rɪp	rip
ˈhɑːd.weər	hardware
ɡreɪv	grave
ˈkæn.ən	cannon
dɪˈskɑːd	discard
ˈsek.sɪst	sexist
juː	ewe
əˈsjuːm	assume
ˈbætl	battle
ˈpɜːtʃəs	purchase
trænsˈfɔːrm	transform
əʊˈbiːs	obese
prɪˈzʌmp.tʃəs	presumptuous
ˌəʊ.vəˈdʒɔɪd	overjoyed
nʌn	none,nun
ˈtʃɒp.ər	chopper
ˈklær.ɪ.faɪ	clarify
ɡriːs	grease
ˈɡet.ə.weɪ	getaway
ˈvɪl.ə	villa
ʃɑːl	shawl
ˈem.ə.rəld	emerald
stɔːrm	storm
ˈpestɪlənt	pestilent
ˈsæk.sə.fəʊn	saxophone
pəˈluːʃn	pollution
pɝːl	pearl
ˈwiː.kli	weekly
dɪˈskləʊz	disclose
ɪkˈspəʊ.ʒər	exposure
ˌprɒp.əˈɡæn.də	propaganda
juːθ	youth
ˈtɪn.səl	tinsel
ˈdʒæv.lɪn	javelin
flɒs	floss
peɪd	paid
ˈpleɪ.fəl	playful
kənˈdʒek.tʃər	conjecture
fɪˈdel.ə.ti	fidelity
ɪnˈvəʊk	invoke
bəˈfeɪ	buffet
keɡ	keg
ˈdem.ə.kræt	democrat
dɪˈspɪk.ə.bl̩	despicable
ˈrek.tæŋ.ɡl̩	rectangle,rectangle
ˌdaɪˈvɜːdʒ	diverge
rɪˈtaɪəd	retired
tɪk	tick
ˈkɑː.bən	carbon,carbon
ˈklæs.ɪ.kəl	classical
dɪˈvoʊtɪd	devoted
ˈmɑː.dʒɪn	margin
ˈmæsɪv	massive
dʒəˈnet.ɪk	genetic
ˈnʌk.l̩	knuckle
rɪˈkɒn.ɪ.səns	reconnaissance
bed	bed
ˈsɑː.dʒənt	sergeant
ˈbraɪ.tən	brighten
ˈɑːmətjʊə	armature
ˈsentʃəri	century
ˈæn.ses.tər	ancestor
ˈsaɪ.kə.pæθ	psychopath
ˈhʌs.ki	husky
ˈkwɒr.əl.səm	quarrelsome
ˈɑː.t̬oʊ	auto
ˈkriː.pi	creepy
rɪˈtaɪər	retire
ˌɪnstɪˈtuːʃn	institution
ˈmɪs.tʃɪf	mischief
ˈhænd.ʃeɪk	handshake
ˈkæb.ɪn	cabin
ˌwerˈæz	whereas
ˈstændərd	standard
ˈrʌfli	roughly
ˈfɔːl.aʊt	fallout
ˈʃæt.əʊ	chateau
ʌnˈspiː.kə.bl̩	unspeakable
ˈem.ɪ.ɡrənt	emigrant
keə(r)	care
ˈkɒk.pɪt	cockpit
ˈkliː.vər	cleaver
ɪnˈtelɪdʒəns	intelligence
ˈfɑːrmər	farmer
ˈmæd.li	madly
ˈæn.ɪ.mət	animate
fəˈtɒɡrəfi	photography
ˈʤiːzəs	Jesus
ˈniːdl	needle
ˈpæn.keɪk	pancake
ˈreɪlrəʊd	railroad
ˈɜː.nɪst	earnest
ˈʃæb.i	shabby
ɪˈmɔːrəl	immoral
ˈbiːst.li	beastly
ˈnoʊtɪs	notice
ˈpəʊ.ɪt	poet
niːl	kneel
ˈbʌm.ər	bummer
ˌmiːˈaʊ	meow
mɑːrt	mart
daɪˈluːʃən	dilution
peɪn	pain
ˈiːstən	eastern
ˈwɪspə(r)	whisper
ˈfuː.lɪʃ	foolish
ˈmer.ɪt	merit
ˌəʊ.vəˈləʊd	overload
ˈbreθˌteɪ.kɪŋ	breathtaking
ˈləʊ.kəm	locum
kɔːl	call
ˈkɔː.di.əl	cordial
ˈbɑː.li	barley
ˈwɑːndər	wander
ɪnˈkwaɪər	inquire
ˈmæs.kjʊ.lɪn	masculine
pæŋ	pang
ˈfɪŋɡər	finger
ˈiːvnɪŋ	evening
rɪˈdjuːs	reduce
ˈkɒn.sə.nənt	consonant
mɔːr	more,moor
ˈdeɪndʒər	danger
ˈmiː.nɪŋ.ləs	meaningless
ˈsɑː.fə.mɔːr	sophomore
wiːk	week,weak
twelv	twelve
ruːf	roof
ˈstʌn.ɪŋ	stunning
ˌhep.əˈtaɪ.tɪs	hepatitis
ˈpriː.tekst	pretext
dɑːrk	dark
laɪn	line
doʊz	doze
ˌentərˈteɪn	entertain
ˈvɑː.li.bɑːl	volleyball
ɪˈvæk.ju.eɪt	evacuate
ˈen.treɪlz	entrails
əˈpɒs.trə.fi	apostrophe
weɪt	wait,weight
ˈʃəʊldə(r)	shoulder
rɪˈspɒns	response
rɪˈkʌvə(r)	recover
ˈfæm.ɪn	famine
ˌkɒr.ɪˈspɒn.dəns	correspondence
diːl	deal
mæsk	mask
stroʊl	stroll
ˈɡreɪp.fruːt	grapefruit
əˈʃɔː.rəns	assurance
ˌrez.ɪˈden.ʃəl	residential
krʌm	crumb
ˈprɑːmɪs	promise
ˈkwɪv.ər	quiver
ˈmʌz.l̩	muzzle
ˈfɪnɪʃ	finish
ˈsʌmθɪŋ	something
ˈfiːlɪŋ	feeling
mæɡˈnɪf.ɪ.sənt	magnificent
ˈkæv.i.ɑːr	caviar
ˈfɔː.teɪst	foretaste
ˈrɑːðə(r)	rather
ˈsʌp.ər	supper
trʌst	trust
stɑːrv	starve
sliːv	sleeve
bɑːk	bark
ˈsʌl.tri	sultry
nɪˈɡeɪt	negate
muːv	move
rɪˈliːv	relieve
bʌd	bud
ˌtek.nɪˈkæl.ə.ti	technicality
ˈəʊpən	open
ˈtʃek.bʊk	checkbook
mɒθ	moth
flɒɡ	flog
njuːˈtræl.ə.ti	neutrality
kənˈkluːʒn	conclusion
lɑːf	laugh
ʃæmˈpeɪn	champagne
ˈfʊt.step	footstep
ˈmuː.vər	mover
ˈneɡ.lɪ.dʒənt	negligent
ˈjuːʒuəli	usually
ˈkeə.fəl.i	carefully
dɑːft	daft
ˈlaɪ.bəl	libel
ˈɡæl.ənt	gallant
səˈpraɪz	surprise
ˈsiːniə(r)	senior
iˈmɜːdʒ	emerge
ˈɪn.pʊt	input
səˈlɪs.ɪ.tər	solicitor
ɪnˈtrʌst	entrust
əˈkʌlt	occult
kʊk	cook
ˈkʌm.bæk	comeback
ˈeɪ.ki	achy
ˈɡɒb.lət	goblet
əˈfɔːrd	afford
ɪˈməʊʃn	emotion
ˈsɑːlɪd	solid
rɪˈviːl	reveal
ˈɪndʒəd	injured
ˈvɪv.ɪd	vivid
ˈhɪd.i.əs	hideous
ˈspeɪs.krɑːft	spacecraft
wiːl	wheel
ˌeɡ.zɒlˈteɪ.ʃən	exaltation
mɜːθ	mirth
bɪˈnev.əl.ənt	benevolent
ˈkaʊnt.ləs	countless
bʌntʃ	bunch
ˈmænə(r)	manner
waɪvz	wives
ˈsem.ə.tri	cemetery
ˈber.ɪŋ	bearing
baɪˈlɪŋ.ɡwəl	bilingual
baɪ	by,bye,buy
sɔː(r)	sore
trænsˈpærənt	transparent
ˌendʒɪˈnɪərɪŋ	engineering
ˈflæn.əl	flannel
ˌɪn.ədˈmɪs.ə.bl̩	inadmissible
ˈɪndɪkeɪt	indicate
ˈfɔːkɑːst	forecast
ˈwɑːlˌpeɪ.pɚ	wallpaper
dʒəʊlt	jolt
reɪ	ray
ʃɒp	shop
θiːf	thief
ˈbeɪsɪs	basis
ˈbʌn.dl̩	bundle
ˈtel.ɪ.skəʊp	telescope
ˈbæŋ.kwɪt	banquet
ˌɪn.kənˈviː.ni.ənt	inconvenient
kən	can
beɪt	bait
ˈbreɪk.daʊn	breakdown
sæŋk	sank
ˈɡæl.ək.si	galaxy
ˈæm.plɪ.tjuːd	amplitude
ˈdʒɑː.ɡən	jargon
ˈmɑː.vəl.əs	marvellous
aɪs	ice
ˈfriː.zər	freezer
ˈrev.ər.ənd	reverend
ˈpɑː.trɪdʒ	partridge
ˈaɪ.si	icy
fɪˈnes	finesse
pɔːˈtreɪ	portray
ˈmesɪdʒ	message
mɪˈstɪəriəs	mysterious
proʊˈsiːd	proceed
ˌəʊvərˈɔːl	overall
ˈkætʃ.ɪŋ	catching
sɪˈnɑː.ri.əʊ	scenario
mjuːt	mute
pəˈfek.ʃən	perfection
ˈreɪdiəʊ	radio
ˈlɒŋ.ɪŋ	longing
ˈpɜː.sɪ.kjuːt	persecute
ˈfjɝː.i	fury
hoʊld	hold
ˈkæʒ.ju.əl	casual
kənˈtɪn.juːd	continued
ˈfɒn.dl̩	fondle
ɪnˈtend	intend
ˈfɝː.oʊ	furrow
ɡler	glare
ˈpoʊ.stɚ	poster
ˈəʊnə(r)	owner
ˈwɜː.ði	worthy
ˈsʌbstɪtjuːt	substitute
spɪt	spit
ɪˈskeɪp	escape
sɪˈkjʊə(r)	secure
ˈsɪriːz	series
ˈdɑːkjumənt	document
ˈpɑːs.wɜːd	password
ˈsʌðərn	southern
suːn	soon
ˌnɔːθˈwest	northwest
ˈpen.sɪv	pensive
ˈskræm.bl̩	scramble
ɡloʊb	globe
ɪkˈskwɪz.ɪt	exquisite
ˈbreɪn.wɒʃ	brainwash
tæk	tack
ˈklæsɪk	classic
dɪˈkleə(r)	declare
dɪˈspaɪz	despise
ˈfɔː.mæt	format
trænsˈleɪt	translate
ɡruːv	groove
ziːl	zeal
ˈkɑːpɪt	carpet
ˈsæv.ɪdʒ	savage
kəˈləʊ.kwi.əl	colloquial
ˈkred.jʊ.ləs	credulous
ˈspɪn.stər	spinster
ˈdɪs.kɔːs	discourse
pænts	pants
ˈdɔː.bel	doorbell
ˈɔːr.ə	aura
frend	friend
ˈtrʌbl	trouble
ˈterəbli	terribly
ɡeɪt	gate,gait
ˌekspekˈteɪʃn	expectation
dʌɡ	dug
ˈdɑːmɪneɪt	dominate
bət	but
ˈtʃæt̬.ɚ.bɑːks	chatterbox
mes	mess
ˈriːdɪŋ	reading
θɝːst	thirst
tuːm	tomb
maɪˈnɒrəti	minority
ˈmeɪnlənd	mainland
bleər	blare
ʃoʊ	show
mɪtst	midst
ˈkɒm.plɪ.ment	complement
ˈfeɪ.bl̩	fable
ˈɡlɪs.ən	glisten
səbˈmɪt	submit
dɪˈpɑːzɪt	deposit
ɡrɑːf	graph
skɑːtʃ	scotch
ɪt.ˈset.ər.ə	etc.
ˌhəʊmˈmeɪd	homemade
ˌɪn.təlˈek.tju.əl	intellectual
ˈlæŋɡwɪdʒ	language
ˈspɒt.laɪt	spotlight
ˈsɪŋ.ɡjʊ.lər	singular
riˈækʃn	reaction
ˈlʌvə(r)	lover
ˈfestɪvl	festival
hɑːrʃ	harsh
əˈpiː.lɪŋ	appealing
ruːʒ	rouge
juˈnaɪtɪd	united
ˈduː.ər	doer
ˈpɪl.əʊ	pillow
swɑːp	swap
ˈɡɒd.es	goddess
ˈskɒl.ə.ʃɪp	scholarship
ˈwæɡ.ən	wagon
ˈdʌb.li	doubly
əˈluːf	aloof
ˈkæptɪn	captain
ˈpɑː.səl	parcel
ˈkʌrənt	current
wɪt	wit
rɪˈzjuːm	resume
spoʊk	spoke
mæd	mad
ˈriːdʒən	region
ˈmiːtər	metre,meter
ɜːrdʒ	urge
ədˈmɒn.ɪʃ	admonish
ˈwʌndəfl	wonderful
ˈkɒŋ.kɔːs	concourse,concourse
ˈpɜːrmənənt	permanent
sɒk	sock
ˈrʊərəl	rural
ˈkɒmplɪkeɪt	complicate
dɪˈfɔːlt	default
wɑːd	wad
ˈbliː.dɪŋ	bleeding
ˈkʌm.li	comely
ˈhed.ɪŋ	heading
təʊ	toe,tow
ˈskeɪ.tɪŋ	skating
əˈfend	offend
raɪ	rye,wry
θɔːrn	thorn
ɪnˈdet.ɪd	indebted
stɑːr	star
ˈriːzn	reason
səʊl	soul,sole
ˈbrʌðər	brother
prəʊ	pro
ˈtɑːpɪk	topic
ˌdɪsədˈvæntɪdʒ	disadvantage
ˈtʃɑːnd.lər	chandler
ˈbɪznəs	business
ˈbæs.tɚd	bastard
skers	scarce
dɪˈsɜː.nɪ.bl̩	discernible
pɪˌkjuː.liˈær.ə.ti	peculiarity
ˌɪn.əˈfen.sɪv	inoffensive
ɑːˈtɪl.ər.i	artillery
ˌmɪsˈfaɪər	misfire
swɒp	swap
ˈpəʊətri	poetry
ˈaʊtə(r)	outer
əˈspær.ə.ɡəs	asparagus
tʃeɪf	chafe
ˈlʌk.əl.i	luckily
ˈfrædʒ.əl	fragile
ˈʃɪv.əl.rəs	chivalrous
stjuːˈpɪd.ɪ.ti	stupidity
ɪˈræd.ɪ.keɪt	eradicate
ɪnˈtrep.ɪd	intrepid
ˈɪnsekt	insect
rɪˈsaɪ.təl	recital
maɪˈnɔːrəti	minority
ˈjəʊ.ɡə	yoga
ˈmɜːrdər	murder
ˈkəʊst.laɪn	coastline
ˌəʊ.vəˈfləʊ	overflow
prɪˈsiːd	precede
ˈklɪə.rɪŋ	clearing
ˈtɜː.nɪp	turnip
ˈæs.mə	asthma
sɑːˈdiːn	sardine
dɪˈkriː	decree
ˈzel.əs	zealous
ˈdraɪvɪŋ	driving
ɪə(r)	ear
ˈmeni	many
ˈtaɪə(r)	tyre,tire
ɪmˈpɔːrtnt	important
fəʊn	phone
ˈhʌzbənd	husband
əˈdʒen.də	agenda
səˈspend	suspend
ɡreɪn	grain
ker	care
teɪp	tape
ˌɔː.təˈmæt.ɪ.kəl.i	automatically
pɑːrt	part
ˈpəʊst.kɑːd	postcard
ˈwel.kəm.ɪŋ	welcoming
ˌɪn.ɪkˈspɪə.ri.ənst	inexperienced
pəˈtɪʃ.ən	petition
ˌɪmplɪˈkeɪʃn	implication
prəˈfeʃn	profession
ˈswiːt.hɑːt	sweetheart
rɪˈzent	resent
ˌriːˈθɪŋk	rethink
ˈɔː.nə.mənt	ornament
ˈhɑːtˌbrəʊ.kən	heartbroken
ˈhɑː.mə.ni	harmony
ˈpæl.peɪt	palpate
buːð	booth
ˈreləvənt	relevant
ˈkreɪdl	cradle
fɔːθ	fourth,forth
bɪt	bit
ˈɔːk.ʃən	auction
ˈʃʌt.l̩	shuttle
sɑːt	sought
bɪˈkəz	because
slɪp	slip
ˈsaʊər	sour
ˈmɒd.ɪ.faɪ	modify
dʌsk	dusk
rɪˈfrɪdʒ.ər.eɪt	refrigerate
skɪn	skin
ˈmætə(r)	matter
kleɪm	claim
dɪˈveləpmənt	development
dɪˈpresɪŋ	depressing
ˈprem.ɪs	premise
ˈstuː.ɚd	steward
kɔːrt	court
ˈkæn.jən	canyon
ˈfɑː.mə.si	pharmacy
kəmˈbaɪn	combine
ˈmɪn.ɪ.tʃər	miniature
ˌænɪˈvɜːsəri	anniversary
tæsk	task
ˈrʌbɪʃ	rubbish
ɪnˈfɔːs	enforce
ɪnˈher.ɪ.təns	inheritance
ˈpæs.təl	pastel
ˈstren.ju.əs	strenuous
nuːˈtræl.ə.t̬i	neutrality
dɪˈziːz	disease
ˈlɑː.kɚ	locker
ˈded.li	deadly
ˈwɜːkə(r)	worker
rɪˈkwaɪər	require
ˈker.ɪk.tɚ.aɪz	characterize
ˈmaɪ.krə.skəʊp	microscope
ˈpepər	pepper
prəˈpoʊzl	proposal
ˈpraɪə(r)	prior
ˈmeʒər	measure
ˈsplɪt.ɪŋ	splitting
rɪˈspek.tə.bl̩	respectable
vaɪˈbreɪt	vibrate
ˌaʊtˈbɪd	outbid
ˈmɑː.kər	marker
ˈsæŋk.tɪ.faɪ	sanctify
rɪˈfreʃ	refresh
ˈnɒm.ɪ.neɪt	nominate
ˈæb.dʒekt	abject
ˈbɝː.oʊ	borough
ˈfroʊzn	frozen
ˈsaɪdweɪz	sideways
ˈkʌlə(r)	colour
ˈtoʊtl	total
ɪnˈhæb.ɪ.tənt	inhabitant
kɒɡˈnɪʃ.ən	cognition
dɪˈzaɪ.nɪŋ	designing
ˈmiːtɪŋ	meeting
əˈlɑːrm	alarm
ˈpɜːrsənl	personal
ˈnɔː.zi.ə	nausea
bɜːp	burp
ˈplæn.ər	planner
fəˈment	ferment
dʒɪər	jeer
kɑːm	calm
dɪˈvɔːs	divorce
hɑːrm	harm
ɪkˈspoʊz	expose
ˌəʊ.və.riˈækt	overreact
ˈwerəbaʊts	whereabouts
ˈdes.ɪ.məl	decimal
təʊld	told
əˈkɜː(r)	occur
ˈmoʊtərsaɪkl	motorcycle
plænˈteɪ.ʃən	plantation
ɪmˈpel	impel
ˈsʌfər	suffer
ˈseʃn	session
ˈɡəʊl.dən	golden
ˈmɔː.təl	mortal
fɜː(r)	fur
ˈdʒænjueri	January
ænˈtiːk	antique
ˈfɔːfɑːðə	forefather
ˈpriːˈpeɪ	prepay
pɑːˌtɪs.ɪˈpeɪ.ʃən	participation
ˈhɪp.ə.krɪt	hypocrite
ˈʃeɪ.ki	shaky
ʌnˈruː.li	unruly
pəˈsen.tɪdʒ	percentage
ˈɡreɪs.fəl	graceful
ˈliː.ɡəl.aɪz	legalize
rɪˈsiːt	receipt
ˈsoʊʃl	social
ˌdɪsəˈpɔɪntmənt	disappointment
ˈsɒl.ɪ.tər.i	solitary
ˌpær.əˈmed.ɪk	paramedic
ˌpɑː.lɪˈmen.tər.i	parliamentary
enˈdev.ər	endeavour
mɒlt	malt
ɪˈfekt	effect
ˌʌndəˈɡraʊnd	underground
ɑːz	ours
kənˈstrɪkt	constrict
ˈpreʃ.əs	precious
ˈdiːpli	deeply
ˈbjʊr.oʊ	bureau
kəˈmjuːnɪkeɪt	communicate
ˈnʌt.meɡ	nutmeg
riːtʃ	reach
ʃɑːft	shaft
ˈsem.iˌsɜː.kl̩	semicircle
ˈeɪ.dʒɪŋ	aging
ˈsæk.rə.mənt	sacrament
ˈfʌni	funny
hɑːɡ	hog
juˈniːk	unique
rʌst	rust
ˈɡriː.tɪŋ	greeting
ɪˈreɡ.jə.lər	irregular
ˈprɒv.ɪns	province
krɒk	crock
ˈpaɪnˌæp.l̩	pineapple
klɒθ	cloth
zɑːr	tsar
ˈpeɪntə(r)	painter
ɑːˈtɪstɪk	artistic
ˈʃæt.ər	shatter
ˈlændˌleɪ.di	landlady
ˈster.aɪl	sterile
dɪˈspaɪt	despite
twaɪs	twice
ˈkwɒntəti	quantity
ˈmæri	marry
ˈmʌndeɪ	Monday
ˈdʒɜːni	journey
ɒdz	odds
trɔːˈmæt.ɪk	traumatic
ˌdes.pəˈreɪ.ʃən	desperation
əˈkwɪt	acquit
ˈlaʊ.zi	lousy
rɪˈpel	repel
ˌæd.əˈles.ənt	adolescent
ˈpɑːn.dɚ	ponder
kɔɪn	coin
bjʊəˈrɒk.rə.si	bureaucracy
ˈhaɪ.drɪ.dʒən	hydrogen
ˌɪm.əˈtʃʊər	immature
ˈnjuː.bɔːn	newborn
ˌben.ɪˈdɪk.ʃən	benediction
ˈʃeltər	shelter
ˈɑː.mər	armour
ˈæm.plɪ.faɪ	amplify
wɑːn	wan
taɪ	tie
ˈweərəbaʊts	whereabouts
əˈflɪk.ʃən	affliction
ɪˈnjuː.mə.reɪt	enumerate
səˈpɔːt	support
ɪnˈkwaɪə.ri	inquiry
ˈspes.ɪ.faɪ	specify
ˈmɒn.jʊ.mənt	monument
ˈteɪk.aʊt	takeout
ˈflɪp.ənt	flippant
tɜːrm	term
heɪst	haste
ˈjʊə.rɪn	urine
ˈsʌr.ə.ɡət	surrogate
θriː	three
ɪɡˈnɪʃ.ən	ignition
ˈɑːm.tʃeər	armchair
rɪˈdiːm	redeem,redeem
spuːk	spook
ˈaɪ.dəl	idol
ˈmeməri	memory
hɑːv	halve
ˈkɒnʃəs	conscious
bentʃ	bench
ˈkɑː.mə	comma
ɪnˈdeɪn.dʒəd	endangered
skwɝːt	squirt
ˈɔːspɪs	auspice
əˈvɜːt	avert
ˈwɒndə(r)	wander
ˈnæs.ti	nasty
ˈsɪɡnətʃə(r)	signature
əʊˈpeɪk	opaque
dɪr	dear,deer
ˈpeɪnfl	painful
ˈstætʃuː	statue
ʌnˈkɒm.ən	uncommon
bʊl	bull
ˈpɑː.stə	pasta
ˈsʌm.ən	summon
ˈaɪ.rɪs	iris
səˈlaɪ.və	saliva
əˈkʌm.plɪʃ.mənt	accomplishment
ˈfɪʃ.i	fishy
ˈlɪtl	little
məˈdʒes.tɪk	majestic
stæf	staff
ˈmɑːstə(r)	master
hiːl	heal,heel
dɪˈmɑːnd	demand
ˈəʊ.və.bɔːd	overboard
fleər	flare
hɜːt	hurt
ɪˈdʒɪp.ʃən	Egyptian
ˈkɒl.ən.dər	colander
ˈdrʌdʒ.ər.i	drudgery
jɑːd	yard
dɪˈlaɪtɪd	delighted
ˈhel.mət	helmet
ˈmæs.ə.kər	massacre
əkˌsel.əˈreɪ.ʃən	acceleration
əˈsweɪdʒ	assuage
ˈsentəns	sentence
waɪn	wine,whine
kənˈsʌmp.ʃən	consumption
ˈbɪt.i	bitty
ɡɔːnt	gaunt
kiː	key,quay
wɪrd	weird
ˌkɑːn.fɪ.den.ʃiˈæl.ə.t̬i	confidentiality
ˈen.sən	ensign
ɪˈnʌf	enough
boʊθ	both
ˈvjuː.pɔɪnt	viewpoint
ˈtʃiː.zi	cheesy
ˈsɑː.fən	soften
ʌnˈset.l̩d	unsettled
sʊt	soot
ˈkɒdʒ.ɪ.teɪt	cogitate
əˈkwaɪər	acquire
əˈkaʊnt	account
həʊld	hold
daɪˈvɜː.sɪ.ti	diversity
ˈəʊ.və.saɪt	oversight
huːˈevə(r)	whoever
jɜː(r)	year
ɪˈsteɪt	estate
rɪˈtaɪə(r)	retire
ˈdres.ər	dresser
ˌæp.rɪˈhen.ʃən	apprehension
ˈnæɡ.ɪŋ	nagging
hoʊl	whole,hole
dɪˈzɑːlv	dissolve
əˈbed	abed
ˈfɒl.əʊ.ər	follower
ˈteɪkˌəʊ.vər	takeover
nəʊp	nope
sɪksθ	sixth
ˈlæv.ɪʃ	lavish
hɪˈstɒr.ɪk	historic
ˈnɒk.aʊt	knockout
ˈplʌn.dər	plunder
ˈzel.ət	zealot
ˈpɑːsəbli	possibly
flek	fleck
ˈspɔːrt.ɪŋ	sporting
dɪkˈteɪ.ʃən	dictation
dɪˈvaʊər	devour
fəʊ	foe
ˈnəʊ.ʃən	notion
dɪkˈteɪt	dictate
vaʊtʃ	vouch
ˈræv.ɪdʒ	ravage
skeə(r)	scare
ɪˈtæl.jən	Italian
ˈkær.ə.væn	caravan
ˈnəʊtɪs	notice
ˈpɜːrsənəli	personally
ˈmɑː.stə.piːs	masterpiece
ˈprɑː.fɪt	prophet
stɔː(r)	store
dəz	does
rɪˈzɜːvd	reserved
dəʊm	dome
ˈraɪtər	writer
ˈmæstər	master
ədˈventʃə(r)	adventure
ˈlɑːdʒɪk	logic
ˌɪn.təˈmiː.di.ə.ri	intermediary
ˈdrɪp.ɪŋ	dripping
pɑːs	pass
ˈliː.də.ʃɪp	leadership
ˈfəʊtəɡrɑːf	photograph
ˈmel.ə.di	melody
kɜːb	curb,kerb
kənˈsɪl.i.eɪt	conciliate
ɪnˈdʒʌŋk.ʃən	injunction
dʒʌdʒ	judge
dɪˈpɑːt	depart
sərˈvaɪv	survive
kəˈrɪə(r)	career
ˈɒn.set	onset
ˈteɪ.lər	tailor
smaɪt	smite
ˈprɒf.ɪ.tə.bl̩	profitable
stɑːrk	stark
ˈtʃɒklət	chocolate
ˈfʊt.ɪŋ	footing
ˈekspɜːrt	expert
ˈjuːzər	user
ˈmɜː.tʃən.daɪs	merchandise
ˈʌt.məʊst	utmost
ˈwɪə.ri	weary
ˈkiːbɔːrd	keyboard
ɪkˈspləʊʒn	explosion
ˈvɪt.ə.mɪn	vitamin
ˈsɪksti	sixty
straɪv	strive
waɪl	while
ˈwɑːʃɪŋ	washing
ˈpɪkˌpɒk.ɪt	pickpocket
ˈsiːˈʃɔː	seashore
siːz	seize
pəˈvɜːs	perverse
ˈʌpwəd	upward
ˈprɑː.stɪ.tuːt	prostitute
rɪˈlent	relent
ˈlɪŋ.ɡər	linger
ˈlaɪ.ər	liar
ˈpæspɔːrt	passport
ˈblaɪnd.li	blindly
ˈberi	bury
əˈbiː.di.ənt	obedient
ˈpɜːrvɜːrt	pervert
ˈtɪpɪkli	typically
ˈlaɪmlaɪt	limelight,limelight
ˈelɪmənt	element
kwɪˈziːn	cuisine
ˈkɒn.sɪ.kwənt.li	consequently
ˈnɪtɪŋ	knitting
ˈpɑː.t̬ɚ	potter
breɪv	brave
dʒiːn	gene
ˌfeəˈwel	farewell
flɜːt	flirt
ˈpɔː.səl.ɪn	porcelain
fəˈlɪs.ɪ.ti	felicity
staɪl	style
ˈæŋɡl	angle
ˈfɔːti	forty
hæd	had
ʃɔːts	shorts
tiːn	teen
rɪˈpɔːt	report
mɑːtʃ	march,March
spɔːrt	sport
ˈdaɪ.ə.lekt	dialect
drɪl	drill
ɪˈkwɪvələnt	equivalent
ɪnˈdaɪt.mənt	indictment
snɒb	snob
rɪˈlæks	relax
ˈneɪtʃə(r)	nature
seɪn	sane
pɪŋ	ping
liːd	lead
træp	trap
kəˈnæl	canal
ˈes.kə.leɪ.tər	escalator
bɪˈheɪvjər	behaviour
ˈdɪn.dʒi	dingy
hoʊm	home
ɪˈmoʊʃənl	emotional
ˈtɔːr.t̬əs	tortoise
ɡɑːnt	gaunt
dɑːk	dark,dock
ˈdɪkʃəneri	dictionary
roʊl	roll,role
ɪˈməʊʃənl	emotional
pəˈtɪkjələli	particularly
ˈæl.i.weɪ	alley
ˈstæl.jən	stallion
ˈtʃɪrfl	cheerful
ˈmɪljən	million
ˈfruːt.ləs	fruitless
dɪˈnaɪ.əl	denial
ˈkʌntrisaɪd	countryside
əˈsɪm.ɪ.leɪt	assimilate
ˈdiː.ə.t̬i	deity
brɪŋk	brink
ˈsleɪ.ər	slayer
ˈnəʊ.bl̩	noble
dɪl	dill
ˈpɜː.ki	perky
ˈhoʊl.dɚ	holder
ˈbaʊn.sɪŋ	bouncing
klɒd	clod
əˈpɑːrt	apart
ˈsʌl.ən	sullen
ˈtaɪ.mɪŋ	timing
ˈblʌd.ləs	bloodless
ˌpriː.hɪˈstɒr.ɪk	prehistoric
slɑːb	slob
θɑː	thaw
rɪˈtæl.i.eɪt	retaliate
pɝːˈfjuːm	perfume
dɪˈtɜːrmɪnd	determined
ˈsaɪ.kɪk	psychic
æmˈniː.zi.ə	amnesia
bɪˈriːv	bereave
dred	dread
əˈmiː.nɪ.ti	amenity
ɪnˈɡeɪdʒ.mənt	engagement
dæm	damn,dam
kənˈfek.ʃən.ri	confectionery
teə(r)	tear
ˌpʌŋk.tjuˈeɪ.ʃən	punctuation
ˈklæt.ər	clatter
ˈstɜː.dʒən	sturgeon
dɪˈskʌvəri	discovery
ˈtæk.tɪk	tactic
kəmˈpəʊ.nənt	component
dɪˈdjuːs	deduce
ˈlæt.ɪ.tjuːd	latitude
əˈtrækt	attract
dek	deck
kwaɪər	choir
daɪs	dice
pərˈfekt	perfect
swɒmp	swamp
frəˈtɜː.nə.ti	fraternity
ʌnˈfrendli	unfriendly
ˈdɒmɪneɪt	dominate
lɔːŋ	long
ɪnˈtens	intense
ˈjʌŋ.stər	youngster
ˈtʃeɪmbər	chamber
ɡeɪv	gave
ʃred	shred
ˈkʌltʃərəl	cultural
ˈdaɪ.leɪt	dilate
ˈtrænspɔːrt	transport
ˈduː.əl	dual
ləˈsɪv.i.əs	lascivious
ˌəʊ.vəˈreɪ.tɪd	overrated
ʌnˈiː.kwəl	unequal
ˈfɪŋ.ɡə.tɪp	fingertip
ˈfɑːrðər	farther
ˈʃaʊər	shower
ˈhɑː.bər	harbour
ˈvæn.dəl.ɪ.zəm	vandalism
ˈskɜː.mɪʃ	skirmish
ɪtˈself	itself
ˈkrɒk.ə.daɪl	crocodile
ˌdaɪ.əɡˈnoʊz	diagnose
ˈkʌstəmz	customs
ʌnˈiː.vən	uneven
dɪˈfɔːm	deform
ˈestɪmət	estimate
streŋθ	strength
əˈbleɪz	ablaze
ˈdæmɪdʒ	damage
vjuː	view
ˈreɪ.ʃi.əʊ	ratio
ɪnˈevɪtəbl	inevitable
peɪst	paste
ˈʃɪp.mənt	shipment
ˈmuːvɪŋ	moving
ˈsevn	seven
ˈsməʊl.dər	smoulder
piːp	peep
ˈɡɑː.blət	goblet
ˈɡɒd.ləs	godless
ˌθæŋksˈɡɪv.ɪŋ	thanksgiving
ˈdænsər	dancer
ɪˈlektrɪkl	electrical
ˈrəʊd.saɪd	roadside
eɪd	aid
tʃɑːns	chance
ˈmɑːrkɪt	market
strɪŋ	string
ˈɡʌt.ər	gutter
kənˈsɪd.ər.ət	considerate
ˌʌn.dəˈmaɪn	undermine
ˈstoʊ.kɚ	stoker
wɪð	with
dɪˈspær.ə.ti	disparity
ˈbreɪnpaʊɚ	brainpower
ˈentə(r)	enter
ræpt	wrapped,rapt
kənˈsɜːrn	concern
ˈkɒmpleks	complex
ˈblɑː.səm	blossom
ˈsɪb.lɪŋ	sibling
dɪˈtætʃt	detached
ˌɪn.dɪ.dʒes.tʃən	indigestion
dɪˈstɪŋ.ɡwɪʃt	distinguished
ˌɪn.ɪˈfɪʃ.ənt	inefficient
blɑːk	block
ˈev.ɪ.dənt.li	evidently
ˌʌpˈhɪl	uphill
skwɪd	squid
ˈkæl.əs	callous
ˈdʒæŋ.ɡl̩	jangle
æd	add
ɡeɪ	gay
ˈʃædəʊ	shadow
ræk	rack
ˈtɒr.ənt	torrent
flæsk	flask
ˈber.ɚ	bearer
teɪk	take
blɒtʃ	blotch
ˈflʌr.i	flurry
ˈbɔɪ.stər.əs	boisterous
ˈɒfə(r)	offer
bɔːrd	board,bored
ˈkiːbɔːd	keyboard
ˈɪnstəns	instance
ˈfəʊ.kəst	focused
eɪdz	aids
ˈprɑːspekt	prospect
fəˈɡet	forget
dɑːb	daub
ˈten.dər	tender
ˈkoʊ.koʊ	cocoa
vɔɪd	void
ˈɜː.θi	earthy
ɪˈvəʊk	evoke
tæɡ	tag
dɪˈklaɪn	decline
ˈpɜːrtʃəs	purchase
ˈweɪtər	waiter
ˈpɑːrtnərʃɪp	partnership
ˈpɑːr.lɚ	parlour
ˈdɑːlər	dollar
ˈfɪzɪks	physics
ˈprɑːbəbl	probable
ˈɪnˌkʌm.ɪŋ	incoming
ˈfæktə(r)	factor
nek	neck
ˈfeɪvərɪt	favourite
rəʊb	robe
ˌpɜːrsəˈnæləti	personality
wɜːld	world
ˈtʃɪrˌliː.dɚ	cheerleader
ˈɪn.fɪ.nət	infinite
mɑːθ	moth
əˈduː	ado
ˈjuːnɪvɜːs	universe
smɑːrt	smart
bɪd	bid
rɪˈspɒnd	respond
ˈʃɪv.ər	shiver
ˈpəʊ.ʃən	potion
klɪə(r)	clear
ˈtʃærəti	charity
ˈɪntərvjuː	interview
ˈtʃæm.pi.ən	champion
ˈkwɑːləti	quality
boʊl	bowl
ˈplæk.ɑːd	placard
raʊz	rouse
ɔːlˈredi	already
rɪˈzent.fəl	resentful
ˈdʒentl	gentle
əˈnjuː	anew
ˈdɪkʃənri	dictionary
pəˈfekt	perfect
bɜːrd	bird
ˈfɜːðə(r)	further
ˈbʊl.dɒɡ	bulldog
ˈnjuː.trəl	neutral
ɪnˈspek.ʃən	inspection
bʌŋk	bunk
θruː	through,threw
ˈlaɪf.taɪm	lifetime
pɝːs	purse
praɪz	prize,prise
ˈɡæl.ər.i	gallery
kwoʊt	quote
kuː	coup
ˈtʃɪkɪn	chicken
ˈdev.ə.steɪ.tɪŋ	devastating
slʌʃ	slush
ˈhəʊl.li	wholly
pleɪɡ	plague
fjuːd	feud
nɜːv	nerve
eɪt	eight,ate
ˈklɑːsruːm	classroom
slaɪd	slide
səˈpraɪ.zɪŋ.li	surprisingly
mɒs	moss
ˌtræns.fəˈmeɪ.ʃən	transformation
ɪˈrep.rə.bl̩	irreparable
her	hair,hare
kɑːv	carve
kəˈləʊ.ni.əl	colonial
ˈtʃiː.tər	cheater
ˈkrev.ɪs	crevice
kəˈmɪʃ.ən.ər	commissioner
dɪˈfend	defend
ˈbækɡraʊnd	background
slaɪt	slight
əˈpɪərəns	appearance
ˌhez.ɪˈteɪ.ʃən	hesitation
ˈplʊə.rəl	plural
ˈdraɪvər	driver
ˈkwes.tʃə.nə.bl̩	questionable
ˈslɒp.i	sloppy
ˌʌnˈnəʊn	unknown
ˈwɪz.əd	wizard
frɒst	frost
ˈbraɪ.dəl	bridal
ˈsmoʊl.dɚ	smoulder
kəʊd	code
bɪˈsaɪd	beside
hedʒ	hedge
ˈɑː.tər.i	artery
stentʃ	stench
ɑː(r)	our
ˈdʒentlmən	gentleman
ˈtaɪtl	title
prəˈpəʊzl	proposal
skɑːr	scar
kənˈɡrætʃuleɪt	congratulate
stjuː	stew
ˈsiːˈsaɪd	seaside
ˈoʊvər	over
ˈsektər	sector
ˈlɪr.ɪ.kl̩	lyrical
ˈfɪl.tər	filter
ˈneb.jʊ.ləs	nebulous
ˈpen.ɪ.tənt	penitent
ˈhaɪ.fən	hyphen
bɒnd	bond
kæsˈkeɪd	cascade
bəʊst	boast
ˈpæt̬.ɚ	patter
əbˈdʒʊər	abjure
ˈklaɪ.mæks	climax
ˈlæŋ.ɡwɪd	languid
ˈbɪldɪŋ	building
meɪnˈteɪn	maintain
hʌntʃ	hunch
taɪl	tile
əˈsem.bli	assembly
əˈbet	abet
ˈɑːt.ləs	artless
ˈvɪdiəʊ	video
pɒʃ	posh
ˈblʌd.i	bloody
ˈleɪbər	labour
ˈkeəfl	careful
prəˈvaɪdɪŋ	providing
kwɪr	queer
ˈdeɪn.dʒər.əs.li	dangerously
ˌɪn.sɪɡˈnɪf.ɪ.kənt	insignificant
ˈæk.jʊ.rə.si	accuracy
ˈiː.pɒk	epoch
ˈkaʊntə(r)	counter
stɪk	stick
ɪnˈvɑːlvmənt	involvement
ɪnˈkɑː.nət	incarnate
wɜːrθ	worth
əˈkweɪn.təns	acquaintance
lenz	lens
fɑːnt	font
flæt	flat
ˈnɪəli	nearly
ˈsɜː.dʒən	surgeon
ˌoʊvərˈkʌm	overcome
ˈseɪlz.mən	salesman
ˈsʌbstɪtuːt	substitute
lɪd	lid
ˈfɔːwəd	forward
ˈɔː.ɡən.ɪ.zəm	organism
ˌɑːfˈʃɔːr	offshore
pɒd	pod
fiːld	field
sɔːrd	sword
hɪˈster.ɪ.kəl	hysterical
ˈpriː.fek.tʃər	prefecture
ˈɔːlsoʊ	also
ˈpɒlətɪks	politics
ˈfɔː.saɪt	foresight
ˈmɒrəl	moral
ɪnˈvaɪt	invite
ter	tear
depθ	depth
ˈɡrəʊsəri	grocery
ˈklʌb.haʊs	clubhouse
ˈɪr.ɪ.ɡeɪt	irrigate
ten	ten
ɪnˈʃɔːrəns	insurance
ˈkʌvərɪŋ	covering
ˈkæptʃər	capture
əˈpəʊnənt	opponent
əˈproʊpriət	appropriate
ʃɔːr	shore
bɪˈjɑːnd	beyond
ˈnɪm.bl̩	nimble
ˈræɡ.ɪd	ragged
ˈdʌm.plɪŋ	dumpling
ˈmenʃn	mention
ˈmɪr.ɪ.kl̩	miracle
koʊp	cope
ʃiːp	sheep
ˌmed.ɪˈkeɪ.ʃən	medication
kənˈsiːv	conceive
ˈkwɒr.ən.tiːn	quarantine
ˈsiːkrət	secret
ˌeɪˈmɒr.əl	amoral
ˈhɔː.məʊn	hormone
vɝːdʒ	verge
ˈpaɪ.pər	piper
ˌpɔːrtˈfoʊ.li.oʊ	portfolio
ˈdeɪ.driːm	Daydream,daydream
ˈhæpi	happy
ˈmuːvmənt	movement
ˈbɔːdə(r)	border
ˈvɪʃ.əs	vicious
muːt	moot
kɔːrs	course,coarse
ˈlaɪt.nɪŋ	lightning
stɔːk	stalk,stork
ˈfaɪər	fire
bɑːθ	bath
ˈsaɪəntɪst	scientist
baɪˈɒlədʒi	biology
ˈsɒlti	salty
ˌɒfˈhænd	offhand
ˈhɒt.laɪn	hotline
kəˈmjuːnəti	community
ˈpeɪntɪŋ	painting
ˈɪmɪdʒ	image
ˈnɔːməli	normally
ˈsɜːrneɪm	surname
ɑːtʃ	arch
rɪˈkʌr.ənt	recurrent
ˈreɡjələr	regular
ˈspɑː.klɪŋ	sparkling
kəmˈpɑːt.mənt	compartment
ˈevriwʌn	everyone
leɪk	lake
səˈdʒest	suggest
ˈdʒuː.vən.aɪl	juvenile
ɪnˈɡræt.ɪ.tjuːd	ingratitude
keɪk	cake
kwest	quest
ˈæd.və.sər.i	adversary
ˌɪn.kəmˈpæt.ɪ.bl̩	incompatible
ɪnˈves.tɪ.ɡeɪ.t̬ɚ	investigator
rɒb	rob
ˈdekəreɪt	decorate
ˈwaɪə.rɪŋ	wiring
ˈdes.tɪ.tjuːt	destitute
rɪˌtæl.iˈeɪ.ʃən	retaliate
ˈɑːr.tʃɚ.i	archery
ˈfɒɡ.i	foggy
ʃʌt	shut
ˈkɑːnʃəs	conscious
ˈfɑː.dɚ	fodder
rɪˈpruːf	reproof
jæŋk	yank
ˈhæs.l̩	hassle
ɪɡˈzempt	exempt
ˈbɔːl.rʊm	ballroom
dɪˈreɪnʤ	derange
ˈsiː.nər.i	scenery
ˌredʒ.ɪˈstreɪ.ʃən	registration
məˈtɜː.nə.ti	maternity
ˈɡeɪ.ə.ti	gaiety
dɪˈskrep.ən.si	discrepancy
sɪˈvɪə(r)	severe
ˈaɪ.sə.leɪt	isolate
ˈɒntə	onto
ˈkjuː.kʌm.bər	cucumber
prɒɡˈnəʊ.sɪs	prognosis
ɪˈnɔː.ɡjʊ.reɪt	inaugurate
ˈɡɒs.pəl	gospel
ɪnˈɡreɪv	engrave
ˈsevnti	seventy
ˌæn.tiˈsəʊ.ʃəl	antisocial
ˈærəʊ	arrow
ˈhɪn.dər	hinder
ˈsɪk.li	sickly
ɪnˈlaɪ.vən	enliven
ˌhjuː.mənˈkaɪnd	humankind
ˈtwenti	twenty
ˈlaɪv.stɒk	livestock
dɪsˈɡaɪz	disguise
ˈæf.ə.bl̩	affable
ˈkeɪ.tər.ɪŋ	catering
dɪˈvel.əpt	developed
krɑːk	crock
ˈpjuːpl	pupil
ˈtaɪərd	tired
ˈiː.ɡl̩	eagle
dɪˈfens.ləs	defenceless
ˈær.əb	Arab
ˈəʊ.və.dəʊs	overdose
ˌloʊ.kəˈmoʊ.t̬ɪv	locomotive
ˈer.i	airy
jɔː(r)	your
dɑːnt	daunt
kæʃ	cash
ˈɪə.rɪŋ	earring
ˈhɔːr.ə.skoʊp	horoscope
lʊr	lure
haʊl	howl
pɔɪnt	point
əˈfɪʃəli	officially
prəˈpəʊz	propose
ˌkɒmbɪˈneɪʃn	combination
ˌhæpˈhæz.əd	haphazard
ˌiː.vəˈluː.ʃən	evolution
ˈkrɪs.məs	Christmas
tʃek	check,cheque
ˈhoʊmwɜːrk	homework
web	web
stretʃ	stretch
ˈɔːl.tər	altar
ˈkɔːt.rʊm	courtroom
seɪ	say
pəʊl	poll,pole
əbˈsiːn	obscene
maɪnd	mind
rɪˈpeɪ	repay
ˈfaʊn.tɪn	fountain
ˈmet.ə.fɔːr	metaphor
prəˌnʌnsiˈeɪʃn	pronunciation
ˈtɔː.təs	tortoise
ˈhæɡ.əd	haggard
ˈbʊk.keɪs	bookcase
ˈaʊt.fɪt	outfit
ˈræðər	rather
ˈsteɪʃn	station
stɒk	stock
ˈsʌn.set	sunset
bʌz	buzz
traɪ	try
siːs	cease
ɪkˈsplɔː(r)	explore
ˈɪn.fəʊ	info
ˈdɪs.kəʊ	disco
əˈfrʌnt	affront
bɪˈkɒz	because
ˈfɜːnɪtʃə(r)	furniture
rɪˈfreɪn	refrain
ˌɪnfəˈmeɪʃn	information
læf	laugh
ˈtraɪəl	trial
ˈfiːtʃə(r)	feature
ˈpɜːpl	purple
dɪˈmen.tɪd	demented
ˈbrɔːd.ʃiːt	broadsheet
ˈɡɜːrlfrend	girlfriend
ɪˈlæps	elapse
ɪkˈspænd	expand
ˈdʌn.dʒən	dungeon
ˈdʒuːniər	junior
sɪk	sick
friːk	freak
ˈbædli	badly
ˌpɒləˈtɪʃn	politician
rɪˈteɪn	retain
ˈʌpwərd	upward
ˈmiː.ti.ɔːr	meteor
fə(r)	for
ˈpɑːs.tʃɚ	posture
əˈsɜːt	assert
rɪˈvjuː	review
ˈaʊt.wəd	outward
ɪnˈdʒek.ʃən	injection
ˈvʌl.ɡər	vulgar
ˈste.rɔɪd	steroid
reɪv	rave
ˈtʃɪəfl	cheerful
ˈfiːvər	fever
ˈpəʊ.stəl	postal
ˈkær.ə.weɪ	caraway
ˈɪrɪteɪt	irritate
ˈfɔː.trəs	fortress
flɒk	flock
ˈleɪ.tənt	latent
deə(r)	dare
ˌdɪsəˈpɪə(r)	disappear
ˈnɑː.sti	nasty
ɡrəʊθ	growth
ˈhʌm.bl̩	humble
ˈter.əs	terrace
dɪˈspjuːt	dispute
ˈfʊt.weər	footwear
fiːd	feed
ˈprɑː.vɝːb	proverb
ˈʌtərli	utterly
ˈsʌn.laɪt	sunlight
ˈdæʃ.ɪŋ	dashing
ˈeb.ən.i	ebony
ˌæd.resˈiː	addressee
ˈskɑː.lət	scarlet
ˈnesəseri	necessary
ˌnevərðəˈles	nevertheless
ˈkloʊðɪŋ	clothing
rɪˈpʌb.lɪk	republic
ˈsiː.mən	seaman
wedʒ	wedge
ˈerə(r)	error
fɔːˈstɔːl	forestall
ˈkɜːrɪdʒ	courage
ˈælkəhɔːl	alcohol
ˈliːdə(r)	leader
bɪˈhed	behead
krʊk	crook
kənˈsɪdər	consider
ˈsʌfərɪŋ	suffering
lɪŋk	link
ˈʌndəweə(r)	underwear
məˈnɪp.jʊ.leɪt	manipulate
moʊd	mode
dʒəʊk	joke
dɪˈsep.ʃən	deception
ˈmʌltɪplaɪ	multiply
ˈɪm.prə.vaɪz	improvise
ˌsuː.pəˈsiːd	supersede
əˈlɔːŋ	along
ræn	ran
ɪˈmɒd.ər.ət	immoderate
wɑːnd	wand
ˈpraʊ.es	prowess
jə	you
ˈsɪmələli	similarly
ˈwɪspər	whisper
ˈdɒkjumənt	document
pɔːk	pork
ɪnˈsɜːt	insert
pjʊə(r)	pure
ˈketʃ.ʌp	ketchup
ˈæd.ʌlt.hʊd	adulthood
ɡroʊ	grow
ˈpoʊ.kɚ	poker
ˈtʃeɪmbə(r)	chamber
ˈtɪk.l̩	tickle
dɪˈsend	descend
dɪˈmɒn.ɪk	demonic
ʌnˈkæn.i	uncanny
ˈemfəsaɪz	emphasize
ˈpaʊərfl	powerful
kənˈkʌʃ.ən	concussion
strɔːŋ	strong
əˈsɪstənt	assistant
ˈsekʃn	section
ˈpʌnɪʃmənt	punishment
ˌəʊvəˈkʌm	overcome
sɪˈɡɑːr	cigar
hɑːˈstɪl.ə.t̬i	hostility
ˈpleɪ.ɡraʊnd	playground
ˈɪʃuː	issue
ˈɑː.tʃər	archer
tæŋk	tank
freɪz	phrase
ˈkrɪs.təl	crystal
ˈkɜː.tə.si	courtesy
mend	mend
ˈprəʊ.tiːn	protein
ˈkæm.ə.maɪl	camomile
rɪˈkɔːl	recall
ˌmæl.njuːˈtrɪ.ʃən	malnutrition
dɪˈraɪd	deride
ɪˈmædʒ.ɪ.nə.bl̩	imaginable
rɪˈfaɪn	refine
ˌæm.bɪˈɡjuː.ɪ.ti	ambiguity
ˈfɔː.tʃən.ət.li	fortunately
fetʃ	fetch
ˈflɔːr.əl	floral
ɪˈlevn	eleven
djuːk	duke
ʃɪft	shift
rɪˈzɔːt	resort
stem	stem
sleɪt	slate
ˌed.ɪˈtɔː.ri.əl	editorial
ˈfɒd.ər	fodder
ˈloʊkeɪt	locate
ˈjuː.nɪ.kɔːn	unicorn
ˈdaɪ.əɡ.nəʊz	diagnose
les	less
nɪk	nick
ˈpɑːkɪt	pocket
ˈpeɪmənt	payment
ˈstɑː.tl̩	startle
ˈbændɪdʒ	bandage
tred	tread
sɪt	sit
ˈpæn.zi	pansy
proʊz	prose
faɪˈnænʃl	financial
ˈtaɪ.pɪst	typist
frɒk	frock
lɪsp	lisp
wɪl	will
ˈemfəsɪs	emphasis
bɪˈsaɪdz	besides
rɪˈper	repair
ɪnˈfɔːrm	inform
æbˈnɔː.məl	abnormal
ˈsuːpəvaɪzə(r)	supervisor
səˈluːt	salute
ˈjɒɡ.ət	yogurt
ˈloʊ.nɚ	loner
ˈbaɪə(r)	buyer
ˈhær.əʊ	harrow
ɪkˈstriːm	extreme
ˈɡæmbl	gamble
kəʊˈɜː.sɪv	coercive
ˈmɒrəli	morally
bɑːb	barb,bob
ˈspɒn.sər	sponsor
ɪˈfeɪs	efface
prəˈdɪdʒ.əs	prodigious
tɒp	top
ɪɡˈzæmpl	example
ˈɡʌvənmənt	government
ˈfiːmeɪl	female
smæk	smack
vaʊəl	vowel
wɪmp	wimp
fɪks	fix
pɚˈvɝːs	perverse
ˈbɜː.ɡlər.i	burglary
fræŋk	frank
əˈsuːm	assume
voʊt	vote
ˈɡɪf.tɪd	gifted
ˌriːˈlɪv	relive
daʊn	down
biːp	beep
nʌm	numb
ˈtʃæt̬.ɚ	chatter
ɪˈliː.tɪst	elitist
ˈprəʊ.lɒɡ	prologue
ˈɔːrɡən	organ
ɡəʊl	goal
ˈæm.ə.tər	amateur
ˈpoʊst.kɑːrd	postcard
əbˈses	obsess
əˈkʌr.əns	occurrence
raɪz	rise
səˈtɪfɪkət	certificate
fɪlθ	filth
ˈaɪs.bɜːɡ	iceberg
ˈəʊnli	only
bɑːrk	bark
ˈtrɒl.i	trolley
ˈfræn.tɪk	frantic
ɪkˈsperɪmənt	experiment
kəmˈpeə(r)	compare
ˈded.ɪ.keɪ.tɪd	dedicated
ˈæm.nɪ.sti	amnesty
frəm	from
ˈɒnɪst	honest
ˈsiːniər	senior
rɪˈɡeɪn	regain
ɪnˈvɪn.sɪ.bl̩	invincible
ˈsɪstə(r)	sister
səˈpɔːtə(r)	supporter
kloʊv	clove
nɑːˈkɒt.ɪk	narcotic
ˈɪn.fə.məs	infamous
ˈfaɪr.bɑːl	fireball
ˈhəʊ.stes	hostess
kwɪər	queer
rɪˈkruːt	recruit
paʊtʃ	pouch
ɪnˈvestmənt	investment
ˈswetər	sweater
ˈher.əld	herald
pækt	pact
flɪk	flick
əˈsaɪ.ləm	asylum
hæɡ	hag
ˈtraɪ.fl̩	trifle
ˈveri	very,vary
rɪˈlaɪ.əns	reliance
ˈsɑː.kɚ	soccer
ˈsʌmwɒt	somewhat
ˈɡræt̬.ə.tuːd	gratitude
prɪˈsɪʒ.ən	precision
ˈɑːn.ti	auntie
ɡɑːl	gall
strænd	strand
kɑːd	card,cod
ˈlʌm.pi	lumpy
ˈkæn.dɪd	candid
help	help
rʌʃ	rush
ˈkɑːntrækt	contract
skaɪ	sky
ˈɔːdiəns	audience
ˌʌnˈfeə(r)	unfair
ˈmædʒ.ɪ.kəl	magical
ˌdʒæpəˈniːz	Japanese
əˈpɑːn	upon
ˈklɪr.ɪŋ	clearing
hen	hen
ˈdʒen.dər	gender
ˈfɪə.səm	fearsome
jərz	yours
ˈsætədeɪ	Saturday
kraʊd	crowd
ˈkʌs.tə.di	custody
lɪt	lit
ˈtraɪæŋɡl	triangle
ˈkæn.vəs	canvas,canvass
wɪʃ	wish
ˈdæn.di	dandy
əˈbɪs	abyss
ˈfiː.təs	foetus
treɪt	trait
ɪnˈvaɪrənmənt	environment
ˌæp.əˈreɪ.təs	apparatus
dʒɝːm	germ
ɑːrˈselvz	ourselves
ˈneɪvi	navy
hæz	has
ˈmɑːn.stɚ	monster
pɪər	peer,pier
ˈvæŋ.kwɪʃ	vanquish
spæn	span
ˌprem.əˈnɪʃ.ən	premonition
ˈaɪ.saɪt	eyesight
ˌprɒs.ɪˈkjuː.ʃən	prosecution
ˈhjuːmərəs	humorous
klæd	clad
kriːd	creed
dræɡ	drag
ɪnˈvent	invent
ˈʃɑːrpli	sharply
ˈhæb.ɪ.tæt	habitat
ɡroʊp	grope
ˈlɒdʒɪkl	logical
bluːm	bloom
əˈpɔɪnt	appoint
prəʊn	prone
pɔːrtʃ	porch
ˈfɒr.ə.nər	foreigner
ˌæb.nɪˈɡeɪ.ʃən	abnegate
ænˈtæɡ.ə.naɪz	antagonize
preə(r)	prayer
ˈnʌmbər	number
ˈpraɪmərəli	primarily
haɪk	hike
ˈɪnə(r)	inner
ˈfjuː.ʒən	fusion
ˈdɪs.ən.tər.i	dysentery
ˈɔːlsəʊ	also
ˈsɒlɪd	solid
ˈklevər	clever
səˈkjʊr	secure
ˈhev.ən.li	heavenly
ˌɪnfərˈmeɪʃn	information
əˈnʌlmənt	annulment
daɪˈæm.ɪ.tər	diameter
ˈmed.əʊ	meadow
ˈsʌŋˌɡlɑː.sɪz	sunglasses
dɪkˈteɪ.tər	dictator
spɜːr	spur
əʊn	own
ˈθɪm.bl̩	thimble
ˈpæl.pə.bl̩	palpable
prəˈdʒek.ʃən	projection
ˈpent.haʊs	penthouse
ˌdaɪ.əɡˈnəʊ.sɪs	diagnosis
ˈsteɪ.di.əm	stadium
ˌmɪs.ʌn.dəˈstænd	misunderstand
rentʃ	wrench
ˈdʒʌm.pi	jumpy
ˈwaɪr.ɪŋ	wiring
ˈfleɪvər	flavour
ˈliːtə(r)	litre
ˈfebrueri	February
ˈbaɪ.ɒp.si	biopsy
tɪndʒ	tinge
əˈstaʊnd	astound
drɪŋk	drink
ˈæbsəluːt	absolute
ˌhəʊ.məˈsek.sju.əl	homosexual
ˌɒp.ərˈeɪ.ʃən.əl	operational
ˈtoʊtəli	totally
treɪn	train
ˈsek.ənd.li	secondly
ˈelbəʊ	elbow
ˈeə.laɪn	airline
ˌdɒk.jʊˈmen.tər.i	documentary
ˈpæs.tʃɚ	pasture
ˈwɔːl.nʌt	walnut
ˈɔːfɪsər	officer
saɪð	scythe
fɔːrˈsiː	foresee
ˈtrɑː.li	trolley
ˈræk.ɪt	racket
ˈmæɡ.ət	maggot
ɡoʊl	goal
prəˈdʌkʃn	production
ˈpɪl.ɡrɪm	pilgrim
ˈkʌmfərt	comfort
dɪˈzaɪə(r)	desire
rɪr	rear
ˈreɪlweɪ	railway
ˈkɑːrpɪt	carpet
ˈhɑːdli	hardly
ˈseɪ.ɪŋ	saying
ˈlaɪv.li.hʊd	livelihood
ˈrek.wɪ.zɪt	requisite
breɪd	braid
hɑːrt	heart
ˈlɪk.wɪ.deɪt	liquidate
ɪˈvent.fəl	eventful
ˈwʌriɪŋ	worrying
ˈkɒtɪdʒ	cottage
ˌrezərˈveɪʃn	reservation
ˈwel.feər	welfare
ˈhɑː.tɪ.li	heartily
ˈsʌmə(r)	summer
bʌf	buff
ˈɡɜː.li	girlie
rɪˈliːf	relief
ɪkˈspɪriəns	experience
kəmˈpliː.ʃən	completion
ˈpep.ə.mɪnt	peppermint
ˌɒpəˈtjuːnəti	opportunity
ˈplʊr.əl	plural
ˈblɪz.əd	blizzard
bɪld	build
ˈlɪl.i	lily
prəˈbeɪ.ʃən	probation
ˈaɪ.sə.leɪ.tɪd	isolated
kəmˈpærɪsn	comparison
ˈlɪt.ər.ə.si	literacy
pər	per
ˈdaɪəmənd	diamond
ɪnˈfæl.ɪ.bl̩	infallible
ˈæv.ɪd	avid
ˈpɪl.əʊ.keɪs	pillowcase
tɪl	till
aɪˈdɪə	idea
ˈsiː.kwəns	sequence
praɪd	pride
kəd	could
ˈmeɪ.dən	maiden
ˈræp.tʃər	rapture
ɡɑːd	God,guard
ɪkˈsplɔɪt	exploit
kənˈdɪʃ.ən.ər	conditioner
ˈfɪɡjər	figure
ˈɑːbdʒekt	object
səˈpraɪzɪŋ	surprising
əˈmæs	amass
kəmˈpres	compress
ˈmjuː.tɪ.leɪt	mutilate
hænd	hand
ˈpeɪ.trən	patron
ˈfɪŋ.ɡə.neɪl	fingernail
ˈkɒn.dɪ.mənt	condiment
əˈbændən	abandon
hɪp	hip
ˈpen.əl.ti	penalty
prɪˈdɪk.ə.mənt	predicament
kənˈteɪnə(r)	container
ˌhɒs.pɪˈtæl.ə.ti	hospitality
ˈmʌf.l̩	muffle
pɑːrˈkeɪ	parquet
ɪnˈʃʊərəns	insurance
rɪˈpel.ənt	repellent
ˈaɪ.rə.ni	irony
koʊv	cove
ˈləʊ.kəs	locus
ˌʌndərˈstændɪŋ	understanding
ˈdʒiː.ni.əs	genius
əˈnaʊns.mənt	announcement
ˈlɔː.suːt	lawsuit
blaʊz	blouse
ˈtɒl.ər.eɪt	tolerate
ˈdɪs.pjuːt	dispute
ʌnˈɑːmd	unarmed
kʌt	cut
ˈvɪɡ.ər.əs	vigorous
ˌæp.əˈθet.ɪk	apathetic
ɑːrz	ours
ˈɡʊr.meɪ	gourmet
ˈæb.stɪ.nəns	abstinence
ˌed.jʊˈkeɪ.ʃən.əl	educational
ˈwɜːk.ʃɒp	workshop
sælˈveɪ.ʃən	salvation
stʌn	stun
hɒɡ	hog
ˌæplɪˈkeɪʃn	application
noʊˈvembər	November
ˈɡʌvn	govern
dəʊˈneɪt	donate
broʊtʃ	brooch
plɔɪ	ploy
prɪˌsɪp.ɪˈteɪ.ʃən	precipitation
naɪs	nice
ˈrek.əm.pens	recompense
dɑːdʒ	dodge
ˈfæb.rɪk	fabric
ˌælkəˈhɒlɪk	alcoholic
wuːm	womb
ˈfɪŋ.ɡə.prɪnt	fingerprint
ˈnəʊ.tər.i	notary
skoʊp	scope
straɪk	strike
ˈhɒlədi	holiday
ˈel.ɪ.fənt	elephant
ˈkɒnstənt	constant
ˌɪn.stəˈleɪ.ʃən	installation
ˈɪntəvl	interval
ˈhæŋ.ɪŋ	hanging
lɪst	list
ˈfʌr.əʊ	furrow
kəmˈpel.ɪŋ	compelling
həˈbɪtʃ.u.əl	habitual
ˈkæpɪtl	capital
rɪˈmaɪn.dər	reminder
rɪˈvɜːrs	reverse
sɔː	saw
ˈbʊl.ə.tɪn	bulletin
ˈlɪk.ɪŋ	licking
ˈɔbʤɪktlɪs	objectless
prɪˈzuːməbli	presumably
ˈmen.juː	menu
ˈɡləʊbl	global
stɑːntʃ	staunch
ˈhɑː.dən	harden
ˈbɜːrθdeɪ	birthday
hɔːrn	horn
rɪˈlaɪ	rely
steə(r)	stare,stair
ˈslʌm.i	slum
vɜːs	verse
ˈduːs	introduce
ˈspiː.dɪŋ	speeding
əˈmeɪzɪŋli	amazingly
ˈpɒn.dər	ponder
rɪˈpʌb.lɪ.kən	republican
bræntʃ	branch
ˈfeɪ.lɪŋ	failing
ˈɔː.tə.mə.biːl	automobile
lɔɪn	loin
ðer	there,their
ˈkɒl.əm.nɪst	columnist
buːˈtiːk	boutique
ˌsɪmpəˈθetɪk	sympathetic
ˈpeɪ.ɒf	payoff
ˈmæn.də.tər.i	mandatory
dɪˈmiː.nər	demeanour
ˈsteɪbl	stable
fərˈevər	forever
ˈkɒləm	column
tjuːb	tube
ˈkrɒs.rəʊd	crossroad
ˈven.juː	venue
prɪˈtens	pretence
rɪˈprəʊtʃ	reproach
ˈwɔːtə(r)	water
ɡɑːlf	golf
ɪnˈsen.sɪ.tɪv	insensitive
baɪl	bile
kæmˈpeɪn	campaign
ˈkæptʃə(r)	capture
ˈrɒk.i	rocky
ɡlʌv	glove
dʒʌɡ	jug
swɔːrm	swarm
ˈliː.ni.ənt	lenient
ˈklevə(r)	clever
hɜːb	herb
ˈretʃ.ɪd	wretched
ˈæb.dɪ.keɪt	abdicate
wɑːnt	want
ˈpaɪlət	pilot
ˈerkræft	aircraft
sɪˈvɪə.li	severely
ˈlev.ɪ.ti	levity
ˈjuːʒuəl	usual
saʊθ	south
ˈseɪvɪŋ	saving
ˈdʒɜːnəlɪst	journalist
ˈɪlnəs	illness
ˈeθ.nɪk	ethnic
ˌæl.jəˈmɪn.i.əm	aluminium
ɡæp	gap
ˈkɑː.fɪn	coffin
rɪb	rib
ˈræn.səm	ransom
æks	axe
ˈstʌf.ɪŋ	stuffing
rɪˈpʌls	repulse
ˈfəʊldɪŋ	folding
stɑːf	staff
ˈhɑːbi	hobby
ˌɪr.ɪˈzɪs.tə.bl̩	irresistible
ˈhəʊ.mi	homey
əˈnaɪ.ə.leɪt	annihilate
ˈɜːrbən	urban
ˈsmʌð.ər	smother
ˌʌn.bɪˈliː.və.bli	unbelievably
ɡɪv	give
ˈkɒm.bæt	combat
ɪkˈstent	extent
ˈbluː.ɪʃ	bluish
hɑːf	half
ˈriːznəbli	reasonably
kɔɪ	coy
ˈhaɪweɪ	highway
ˈpær.ət	parrot
dɪˈtɪə.ri.ə.reɪt	deteriorate
pluːm	plume
ˌɒbzəˈveɪʃn	observation
pɑːrk	park
ˈkredɪt	credit
treɪs	trace
ˌkɒm.plɪˈmen.tər.i	complimentary
səˈbɔː.dɪ.nət	subordinate
aɪˈtɪn.ər.ər.i	itinerary
ˈfɑːloʊ	follow
ˈkjʊriəs	curious
ˈsɪə.ri.əl	cereal,serial
ˈkɑːnsept	concept
ˈvɜː.bəl	verbal
kənˈsiː.tɪd	conceited
ˈfɪŋɡə(r)	finger
ˈdiː.sənt	decent
taʊəl	towel
ˈʃɑːpli	sharply
sɪnˈsɪr	sincere
kənˈsjuːm	consume
klæm	clam
presˈtɪdʒ.əs	prestigious
hʌnt	hunt
ˌɒm.nɪˈprez.ənt	omnipresent
ruːm	room
steɪdʒ	stage
kəʊˈɪn.sɪ.dəns	coincidence
ˈslʌm.bər	slumber
nuː	new,knew
ˈstrɒŋ.li	strongly
kwæk	quack
ˈblæk.aʊt	blackout
kræk	crack
ˈren.dər	render
ˈmɑːtɪn	marten
ˈɒt.ər	otter
ˈmʌðə(r)	mother
ʃoʊˈfɝː	chauffeur
ˈven.dɪŋ	vending
səˈplɑːnt	supplant
ˈsuː.pə.mæn	superman
ˈbʌtn	button
ˈsprɪŋ.kl̩	sprinkle
dəʊs	dose
bʌn	bun
ˈnɑː.t̬i	naughty
ˈfaɪ.nɪst	finest
tekˈniːk	technique
ˈædvətaɪz	advertise
ˌsuː.pəˈstɪʃ.əs	superstitious
ɪnˈsɒm.ni.ə	insomnia
dɪˈsɔː.ɡə.naɪzd	disorganized
ˈprəʊses	process
ˌɪn.dɪˈspjuː.tə.bl̩	indisputable
twɜːl	twirl
ˈbɑːdi	body
rɪˈvendʒ	revenge
ˈsɒs.ɪdʒ	sausage
eɪm	aim
ˈstuːpɪd	stupid
ˈempaɪər	empire
koʊˈɑː.pə.reɪt	cooperate
ˈelboʊ	elbow
ˌkɒn.trəˈdɪkt	contradict
twaɪn	twine
ˈsɜːrkl	circle
tɑːsk	task
əbˈseʃ.ən	obsession
ˈkɜː.sɪd	cursed
ˈmaɪ.zər	miser
ˈɪɡ.nər.əns	ignorance
ˌkɒn.trəˈvɜː.ʃəl	controversial
dʒɪr	jeer
ˈlaɪsns	license,licence
hel	hell
ˈiːzəli	easily
siːl	seal
dʒəˈner.ɪk	generic
dʒiˈɒɡrəfi	geography
ˌek.spləˈreɪ.ʃən	exploration
ˈslaɪ.mi	slimy
ˈevri	every
frɪndʒ	fringe
ˈhænd.fʊl	handful
ˌsɜː.kəmˈstæn.ʃəl	circumstantial
θwɔːt	thwart
ɪntʃ	inch
məʊˈtel	motel
ˈtem.pər	temper
rɪˈtaɪərmənt	retirement
veɪs	vase
ˈæp.ɪ.taɪ.zɪŋ	appetizing
ˈpep.ər.i	peppery
ˈwʌri	worry
ˈdrɑːmə	drama
kleɪ	clay
ˈnek.ləs	necklace
dʒiːp	jeep
ˌbaɪˈlæt.ər.əl	bilateral
pəˈsep.tɪv	perceptive
ˈmæn.ɪ.fest	manifest
pɪk	pick
ˈoʊpənli	openly
ˈkruːəl	cruel
ˈɔː.bɪt	orbit
ˈstræn.dɪd	stranded
kruː	crew
dʌl	dull
bəˈluːn	balloon
kriˈeɪt	create
dɪˈplɔː.rə.bl̩	deplorable
strɪp	strip
fɔːt	fought,fort
tʃuː	chew
ˈaɪ.braʊ	eyebrow
ˌʌn.prɪˈdɪk.tə.bl̩	unpredictable
ˌen.iˈmɔːr	anymore
əˈproʊtʃ	approach
ɪnˈtent	intent
ˈpɒl.ɪ.ɡrɑːf	polygraph
ɡʌlp	gulp
pəˈmɪs.ɪv	permissive
dɪˈlɪvəri	delivery
ˈjoʊ.ɡɚt	yogurt
ˈprɪzn	prison
eɪdʒ	age
bæθ	bath
ˈkʌrɪdʒ	courage
ˈkɒn.stɪ.tjuːt	constitute
staʊt	stout
kləʊð	clothe
ˌhɒrɪˈzɒntl	horizontal
swɒt	swat
ˌælkəˈhɔːlɪk	alcoholic
rəʊˈbʌst	robust
ˈkʊʃ.ən	cushion
ˈbaɪər	buyer
kəmˈpleks	complex
kənˈten.tɪd	contented
əˈrɪəz	arrears
kəˈrɑː.ti	karate
ˌprɒv.əˈkeɪ.ʃən	provocation
ˈkɪtʃɪn	kitchen
swaɪn	swine
ˌpɑːpjuˈleɪʃn	population
ˈver.ɪ.faɪ	verify
leɪs	lace
swɪft	swift
strʌk	struck
ˈkjʊəriəs	curious
ˈnɒlɪdʒ	knowledge
ˈten.ɪs	tennis
ˈdeɪ.tə.beɪs	database
ˈdʒenjuɪn	genuine
ˈɪtəli	Italy
ˈrʌbə(r)	rubber
naɪf	knife
ˈseɪ.bl̩	sable
ədˈvɜːs	adverse
rʌt	rut
stʌf	stuff
ɡlæd	glad
wɪðˈhəʊld	withhold
ˈbetər	better
prɪˈfɜːr	prefer
stɜːr	stir
ˌeɪviˈeɪʃ(ə)n	aviation
ɡrʌb	grub
tʃiːz	cheese
ˈfɒrɪst	forest
spred	spread
ˈwɪn.di	windy
ˈsiː.kwəl	sequel
ræsp	rasp
ˈsɜːkl	circle
ˈmʌn.θli	monthly
pəˈteɪtəʊ	potato
iˈmɜːrdʒ	emerge
ɪkˈspend	expend
tæks	tax
ˈsɜːrvɪs	service
ˈpeɪʃnt	patient
ɔːlˈmaɪ.ti	almighty
hɑːntʃ	haunch
ˈhɜːri	hurry
ˌɪn.əˈprəʊ.pri.ət	inappropriate
ˈspaɪsi	spicy
ˈlæs.ər.eɪt	lacerate
ˈneɪ.tɪv	native
prəˈduːs	produce
wɜːrk	work
ˈevriweə(r)	everywhere
skwer	square
ˌiːkəˈnɑːmɪk	economic
ˈkʊki	cookie
brɑː	bra
ˈʌl.sər	ulcer
əˈrest	arrest
hɜːrz	hers
ɪmˈpɜː.tɪ.nənt	impertinent
ˈplen.tɪ.fəl	plentiful
ˈdʌzn	dozen
ˈlɔːn.dri	laundry
ˈθɔːt.fəl	thoughtful
ˈpuː.dl̩	poodle
laɪð	lithe
meɪt	mate
haɪt	height
ˈtɜː.tl̩	turtle
ˈɡɑːdˌmʌð.ɚ	godmother
ɡlæs	glass
əˈmʌŋ	among
ˈtɪkɪt	ticket
blaɪnd	blind
dɪˈzaɪ.nər	designer
ˈvaɪə.lət	violet
dɪsˈɡreɪs	disgrace
ˈhændl	handle
ˈhaʊshoʊld	household
ˌɪm.pəlˈaɪt	impolite
rɪˈleɪʃnʃɪp	relationship
ræt	rat
ˈedɪtə(r)	editor
ˈpəʊ.ni	pony
fəˈren.zɪk	forensic
əˈɡriː.ə.bl̩	agreeable
ˈtəʊtl	total
ˈekspɜːt	expert
ˈvɒl.ən.tər.i	voluntary
ˈlaɪbri	library
ˈdɪfrəns	difference
ɪkˈstrɔːrdəneri	extraordinary
ˈkʌm.fət.ləs	comfortless
ˌlem.əˈneɪd	lemonade
ˈɪm.ɪ.teɪt	imitate
ˌəʊ.vəˈteɪk	overtake
ˈsɜː.tɪ.faɪd	certified
ðen	then
praʊl	prowl
pɑːm	palm
ˈhɪp.nə.taɪz	hypnotize
ˈfɒl.kən	falcon
ˈhel.pər	helper
tɜːk	turk
ðiː	thee
ˌpɜːsəˈnæləti	personality
əˈbrest	abreast
ˈprɒbəbli	probably
sper	spare
ˈstuːdioʊ	studio
ˌkɒr.ɪˈspɒnd	correspond
ʃɒk	shock
wɔːn	warn,worn
ˈdɪstəns	distance
plɑːt	plot
ʃerd	shared
ˈvɜːtɪkl	vertical
ˈtreɪ.nər	trainer
ɪnˈkriːsɪŋli	increasingly
frʌnt	front
ˈklʌs.tər	cluster
ɡɒlf	golf
ˈreɡjələli	regularly
ˈlɒk.ɪt	locket
ˈdɑː.ɡi	doggy
ˈfaɪnəli	finally
ɪnˈkred.ɪ.bli	incredibly
treɪl	trail
ˈkɒn.vənt	convent
ɪˈfem.ɪ.nət	effeminate
kwiːn	queen
ˈsɪəriəs	serious
ˈsɪŋɡl	single
leɡ	leg
fɪfθ	fifth
ˈfeðə(r)	feather
ʌnˈfeɪθ.fəl	unfaithful
brɪŋ	bring
slæŋ	slang
sweɪ	sway
ˈɑː.mə.mənt	armament
ˈlez.bi.ən	lesbian
ˈmɜː.kjʊ.ri	mercury
sʌn	son,sun
reə(r)	rare
ˈwɪnə(r)	winner
ˈsɪmələ(r)	similar
ˈsel.ər	cellar,seller
ˈtʌtʃ.daʊn	touchdown
ˈtæp.ɪ.stri	tapestry
skuːl	school
kənˈfaʊnd	confound
əˈprəʊtʃ	approach
ˈliː.ɡəl.i	legally
dɪˈzɜːtɪd	deserted
ˈɒm.lət	omelette
ˈen.vi.əs	envious
ˈɑːr.tʃɚ	archer
ˈtɒp.l̩	topple
ˈpækɪdʒ	package
ˈbæk.eɪk	backache
frɑːɡ	frog
ɪnˈfɔːml	informal
kənˈtempəreri	contemporary
zoʊn	zone
ˈɡʌvərn	govern
ˈkɔː.ʃən	caution
kruːd	crude
mɔːn	mourn
ˈtuːθ.peɪst	toothpaste
ɪˈmɜːs	immerse
dɪˈzɜːt	dessert
ˈprɑːses	process
bɒm	bomb
kəˈlɪɡ.rə.fi	calligraphy
ˈmeɪ.kər	maker
trænzˈmɪt.ər	transmitter
ɪnˈræpʧə	enrapture
siːð	seethe
reɪn	rain,rein,reign
ˈdɪə.rɪst	dearest
ˈsɑː.dɚ	solder
kɔː	caw
mɪks	mix
ˈfɪzɪkli	physically
ˈredʒ.ɪ.stəd	registered
ˈʃep.əd	shepherd
səkˈsesfl	successful
pɑːθ	path
rɪˈvɪʒn	revision
mɪŋk	mink
tɔːl	tall
ˈfɔːrti	forty
ˈtruːli	truly
ˈrestrɑːnt	restaurant
ˈledʒ.ənd	legend
ˌaʊtˈdɔːrz	outdoors
ɡləʊt	gloat
kæn	can
ɪˈliːt	elite
ˈspæt.ər	spatter
ˈhɑːdnɪs	hardness
ˈmaɪ.strəʊ	maestro
ˈfeəli	fairly
sɪlk	silk
əbˈstrʌk.ʃən	obstruction
ˈkrəʊ.ʃeɪ	crochet
krʌʃ	crush
ˈsteə.keɪs	staircase
ˌmɑː.dʒəˈriːn	margarine
joʊk	yolk,yoke
bəˈnɑːl	banal
skɔː	score
ˈsɪəriəsli	seriously
dʒɑː	jaw
ˈaɪlənd	island
ˈnəʊt.bʊk	notebook
ˈrek.ləs	reckless
prækˈtɪʃ.ən.ər	practitioner
ˈdʌbl	double
pɔːt	port
ˈkænsər	cancer
pɪn	pin
tʃeɪst	chaste
əˈkrɒs	across
rɪˈvəʊk	revoke
drɑːft	draft,draught
pəʊstˈpəʊn	postpone
ˌdaʊnˈləʊd	download
pəˈspaɪər	perspire
ˈsiːlɪŋ	ceiling
bɔːl	ball
pəˈspek.tɪv	perspective
ˈhæmə(r)	hammer
vɑːz	vase
ˈbraɪdz.meɪd	bridesmaid
nɔːrm	norm
ɪnˈfɜː.mə.ri	infirmary
ˈeniwʌn	anyone
briːð	breathe
koʊn	cone
əˈseɪl	assail
ʃeɪk	shake
ˈmɪʃ.ən	mission
ɪmˈpres	impress
ˈbaɪn.dɪŋ	binding
əˈsaɪn	assign
ekˈsen.trɪk	eccentric
ˈsɜːrfɪs	surface
swɔːrn	sworn
rɪˈsiː.vər	receiver
ˌek.spɜːˈtiːz	expertise
dɪˈsɒn.ər	dishonour
ˈhʌn.i	honey
ɔːˈθɒrəti	authority
ˈbɪznəsmæn	businessman
ˈkrɒk.ər.i	crockery
prɑːp	prop
ˈʃʊəli	surely
woʊk	woke
rɪˈkʌv.ər.i	recovery
ˈmɑːnɪtər	monitor
kwaɪr	choir
ˈbed.taɪm	bedtime
mɪˈræk.jʊ.ləs	miraculous
ʌpˈstæn.dɪŋ	upstanding
ˈsɜː.dʒər.i	surgery
pæk	pack
ˈsɪmbl	symbol
ˌpriːzenˈteɪʃn	presentation
ˈelɪɡənt	elegant
ˈprɒs.ɪ.kjuː.tər	prosecutor
dɪˈsmæn.tl̩	dismantle
ˈflaʊə(r)	flower,flour
ˈkləʊk.rʊm	cloakroom
tʃɑːt	chart
ˈpɜː.mə.nənt.li	permanently
ˈstepˌfɑː.ðər	stepfather
ˈpær.ə.sɒl	parasol
ˈdjuː.li	duly
ˈɡʌn.faɪər	gunfire
ˈpaɪlətɪʤ	pilotage
pres	press
kəˈmɜːrʃl	commercial
ɪkˈsaɪt	excite
əˈsaɪn.mənt	assignment
ɔːlˈraɪt	alright
ˈfɔː.mən	foreman
ˈtwaɪ.laɪt	twilight
ɪˈnɔː.dɪ.bl̩	inaudible
ˈnjuː.li.wed	newlywed
ˈpaʊdə(r)	powder
dɪˈvəʊtɪd	devoted
mɪl	mill
ˈkʌtə	cutter
ˈswet.i	sweaty
rɒθ	wrath
ɪnˈdʌldʒ	indulge
ˈɔɪ.stər	oyster
tekˈnɒlədʒi	technology
ˈkætəɡəri	category
məˈmɔː.ri.əl	memorial
ˈæk.rɪd	acrid
ˈæn.tʃə.vi	anchovy
rəʊt	wrote
tʃiːt	cheat
ˈdɔː.weɪ	doorway
druːp	droop
ˈblʌb.ər	blubber
wʊlf	wolf
snɔːt	snort
ˈʧæstɪzmənt	chastisement
ˈtʃɜːtʃ.jɑːd	churchyard
fen	fen
ʌnˈdʌn	undone
lɒs	loss
hɑːm	harm
ˈkəʊ.lə	cola
dɪˈspɜːs	disperse
ˈpræktɪkli	practically
ˈzɪərəʊ	zero
ˌɪn.əˈveɪ.ʃən	innovation
ˈmeʒəmənt	measurement
ˈden.təl	dental
ˈtæk.i	tacky
ˈpɔː.li	poorly
ɪnˈvɑːlv	involve
ˈpɒn.dər.əs	ponderous
wɔːmθ	warmth
ˈbʌm.pi	bumpy
ˈhevɪli	heavily
ˈɡæmblɪŋ	gambling
kənˈtempt	contempt
əˈlaɪt	alight
ˈtʃæp.əl	chapel
ˈkɒŋ.kər	conquer
ˈhæn.dɪ.kæpt	handicapped
ɪnˈlaɪ.tən	enlighten
ˌaʊtˈraɪt	outright
dɪtʃ	ditch
ˈhɑːr.bɚ	harbour
ˈeksɪt	exit
ˈlɪt.ər.ər.i	literary
ˈfɪʃə	fisher
ˌɪntəˈrʌpʃn	interruption
paʊnd	pound
ˈtʃæptər	chapter
ˌdem.ənˈstreɪ.ʃən	demonstration
ˈnuːkliər	nuclear
prəˈpɔːrʃn	proportion
kɔː(r)	core
blʌf	bluff
kɑː(r)	car
hɑːrp	harp
fiːnd	fiend
ˈmoʊtər	motor
kənˈsʌl.tənt	consultant
ˈbʊl.ə.vɑːrd	boulevard
ˈdrɔː.bæk	drawback
ˈdɑːktər	doctor
held	held
meə(r)	mayor
ˈdɪstrɪkt	district
ˈɡɪɡ.l̩	giggle
ˈdæm.ɪ.dʒɪŋ	damaging
ˈel.ɪ.veɪt	elevate
kloʊn	clone
ləʊ	low
ˈsɪmpəθi	sympathy
bɜːst	burst
ɪkˈstɜː.nəl	external
ˈvjuː.ər	viewer
ˈæf.lu.ənt	affluent
ˈkæt̬.əl.ɑːɡ	catalogue
ˈpɜːrpəs	purpose
ˈek.saɪl	exile
ɪkˈstend	extend
ˈkʌbərd	cupboard
ˈɡɑː.spəl	gospel
trentʃ	trench
ˈfræk.tʃər	fracture
roʊz	rose
pəˈlær.ə.ti	polarity
dɪˈstrʌkʃn	destruction
əˈmɪdst	amid
prəˈkleɪm	proclaim
ˈɡlæd.li	gladly
ˈprəʊ.tə.taɪp	prototype
wɒt	what
ˈlaɪ.tər	lighter
sæŋ	sang
ʌnˈwɜː.ði	unworthy
ˌef.ɪˈkeɪ.ʃəs	efficacious
ˌfɪfˈtiːn	fifteen
ˈkres.ənt	crescent
ɡroʊv	grove
ˈsæt̬.ən	satin
ˈtɑː.pl̩	topple
frʌnˈtɪər	frontier
ˈɡluː.mi	gloomy
hjuːdʒ	huge
ˌprɪnˈses	princess
ˈkʌzn	cousin
ˈwɜːriɪŋ	worrying
ˈmʌs.təd	mustard
rɪˈzaɪd	reside
təˈɡeðə(r)	together
mer	mare
ˈfɒl.sɪ.faɪ	falsify
ˌpɝː.səˈvɪr	persevere
ˈfjuː.dʒɪ.tɪv	fugitive
ˈʌnjən	onion
ˌoʊ.vɚˈfloʊ	overflow
ˌreprɪˈzentətɪv	representative
ˈneɪbərhʊd	neighbourhood
ˈɪr.ɪ.teɪ.tɪŋ	irritating
ˈsæt.ɪn	satin
ˈhɑː.t̬i	haughty
ˈreɪsɪŋ	racing
pliːzd	pleased
rɪˈfɔːm	reform,reform
ˈpjʊə.rɪ.faɪ	purify
ˌædvərˈtaɪzmənt	advertisement
məˈdʒɪʃ.ən	magician
ˈster.i.ə.taɪp	stereotype
ˌɪntərˈvenʃn	intervention
dɪˈzɜːv	deserve
ˈtwɪt.ər	twitter
ˈskaʊn.drəl	scoundrel
skwiːk	squeak
nʌdʒ	nudge
ˌpɒp.jʊˈlær.ə.ti	popularity
ˈθʌrəli	thoroughly
ˌdɪs.ɪnˈher.ɪt	disinherit
rɪˈpɔː.tər	reporter
ˈhaɪ.nəs	highness
feɪm	fame
ɪmˈprɒb.ə.bl̩	improbable
ˈləʊn.li.nəs	loneliness
ˌdel.ɪ.kəˈtes.ən	delicatessen
ɡɪft	gift
ˈfaɪər.ɑːm	firearm
rəʊˈtʌnd	rotund
ˈdɔːtər	daughter
eɪl	ale,ail
fɔːˈmæl.ə.ti	formality
hʌsk	husk
plaɪt	plight
ˈmez.mə.raɪz	mesmerize
əˈkʌm.plɪs	accomplice
ˈɪr.ɪŋ	earring
prɒkˈsɪm.ɪ.ti	proximity
ɪnˈkɔː.pər.eɪt	incorporate
fens	fence
feər	fare
mɪst	mist
vəʊˈkeɪ.ʃən.əl	vocational
ˈprɪz.əm	prism
rɪˈkɜːr.ənt	recurrent
ˈkæri	carry
drɒp	drop
flæɡ	flag
truːp	troop
ʌnˈɡreɪt.fəl	ungrateful
ˌprɒk.ləˈmeɪ.ʃən	proclamation
rɪˈpjuːt	repute
kwaɪt	quite
roʊt	wrote
ˈbɪljən	billion
ˈrɪt.ju.əl	ritual
ˈtəʊ.stər	toaster
ˈkrʌm.pl̩	crumple
ˈfjuːər	fewer
blʌd	blood
dɪˈtekt	detect
ˈkɒf.ɪn	coffin
ˈkɒntent	content
nəˈɡəʊ.ʃi.eɪt	negotiate
pɝː	purr
blæst	blast
spɑːrk	spark
ˌmær.əˈwɑː.nə	marijuana
ˈbɑː.t̬l̩d	bottled
ədˈhɪə.rəns	adherence
ˈkær.ɪdʒ	carriage
pəˈtɜː.nɪ.ti	paternity
dɪər	deer
ˌær.ɪˈstɒk.rə.si	aristocracy
beɪk	bake
ˈɡɜːlfrend	girlfriend
ʌnˈlaɪkli	unlikely
ˈtekst.bʊk	textbook
tʃɑːk	chalk
bruːt	brute
ˈkæn.dər	candour
let	let
ˈfreɪ.ɡrəns	fragrance
ˈfʌndˌreɪ.zər	fundraiser
ɪnˌvaɪrənˈmentl	environmental
pɪkˈtɔː.ri.əl	pictorial
ˈtəʊtəli	totally
niː	knee
ˈhaʊzɪŋ	housing
ədˈvaɪ.zɪd.li	advisedly
mɒm	mom
aɪˈdentəti	identity
ˈæroʊ	arrow
rɪˈzɒlv	resolve
ˈɔː.tʃəd	orchard
ˈnɜːvəs	nervous
dreɪk	drake
ˈkloʊ.ʒɚ	closure
pæθ	path
ˈkɒfi	coffee
dɪɡ	dig
kwəʊt	quote
ˈkʌrəntli	currently
ˈspɑːn.sɚ	sponsor
ˈkɒm.ɜːs	commerce
ˌkɒm.prɪˈhend	comprehend
pliːz	please
əˈdʒʌst.mənt	adjustment
kənˈfed.ər.ət	confederate
səbˈmɜːdʒ	submerge
ˈpæn.θər	panther
ˈdʒɜː.nə.lɪ.zəm	journalism
pɑː	paw
dɪˈsɜːn	discern
ɪˈdʒekt.ʃən	ejection
ˈwɔː.lɒk	warlock
ˈɒpəsɪt	opposite
ˈstrʌktʃər	structure
ˈklɔɪ.stər	cloister
ˌres.tərˈeɪ.ʃən	restoration
ˈsɝː.kjʊ.lɚ	circular
ˈʃædoʊ	shadow
təʊl	toll
ʌmˈbrelə	umbrella
ˈsɒf.ə.mɔːr	sophomore
kəʊst	coast
əˈmend.mənt	amendment
ˈbɒrəʊ	borrow
ˈserəməni	ceremony
ˈbrɔːdkæst	broadcast
ˈloʊnli	lonely
dɪˈskʌʃn	discussion
ˌkɑːntrɪˈbjuːʃn	contribution
ɪˈmens	immense
əˌlɔːŋˈsaɪd	alongside
kəˈlek.tɪv	collective
smɑːt	smart
ˌɑːˈmen	amen
ɡriːd	greed
ʌnˈsɜːtn	uncertain
treɪ	tray,trey
ˈdəʊ.nʌt	doughnut,donut
ænˈten.ə	antenna
njuː	new,knew
ʃɑːrk	shark
ˈwɑː.tʃɚ	watcher
ˈkrɪtɪsaɪz	criticize
ˈɑːdli	oddly
ˈfaɪə.ri	fiery
ˈɪndəstri	industry
ˈɑːrm.tʃer	armchair
rɪˈpleɪs	replace
ˈkɑːr.vɚ	carver
ˈɡɑː.di.ən	guardian
ˈəʊ.di.əs	odious
ʃætˈoʊ	chateau
plɒd	plod
ˈlɔːjər	lawyer
ˈaʊə.ɡlɑːs	hourglass
mɝːθ	mirth
klɔːz	clause
taʊn	town
ˈreɪ.sɪ.zəm	racism
ˌkæp.ʊˈtʃiː.nəʊ	cappuccino
ˈmɪn.ɪ.maɪz	minimize
neɪm	name
ˈlaɪbrəri	library
ˌʌnˈlaɪk	unlike
lɑːd	lard
ˈmær.ɪ.təl	marital
əˈkʌstəm	accustom
ˌdaɪ.əˈriː.ə	diarrhoea
ˈlesn	lesson
pʌn	pun
ˈhɪn.drəns	hindrance
tæp	tap
əˈlaɪk	alike
kəˈmɑːnd.mənt	commandment
əˈbaʊt	about
dɪŋ	ding
ˌkeɪ.pəˈbɪl.ɪ.ti	capability
ˈfɪdʒ.ɪt	fidget
rɪˌspɒnsəˈbɪləti	responsibility
ˈenibɒdi	anybody
saɪˈkɒl.ə.dʒi	psychology
dɪˈpriː.ʃi.eɪt	depreciate
ˈfɪn.ɪʃ	Finnish
əs	us
weəˈbaɪ	whereby
ˈkæl.əm.ni	calumny
ˈflʌk.tju.eɪt	fluctuate
ˈdeɪ.tɪd	dated
spʌndʒ	sponge
ˌkwɒlɪfɪˈkeɪʃn	qualification
ˈkʌl.ə.ləs	colourless
riːðz	wreath
prəˈpɔːʃn	proportion
fəˈlɑːsəfi	philosophy
sketʃ	sketch
ˈmɒd.juːl	module
ˈsuː.ðɪŋ	soothing
pænt	pant
ˈpɝː.tən.ənt	pertinent
ˈbɜː.ɡər	burger
ˈvæljuəbl	valuable
ən	an
ˈlaɪvli	lively
ˌdɪsəˈɡriːmənt	disagreement
waɪf	wife
klæmp	clamp
tʃeɪs	chase
ˈmɪnɪməm	minimum
ˈfɪb.ər	fibber
ˈsɔːftli	softly
prɪˈzaɪd	preside
tʃæsˈtaɪz	chastise
əbˈzɜː.vəns	observance
ˈnɪrli	nearly
ˈfaɪr.wɝːk	firework
ɡɔːdʒ	gorge
ˈbɑːθruːm	bathroom
kriˈeɪ.tɪv	creative
ˈfel.ə.ni	felony
ˈfɑːmə(r)	farmer
suːð	soothe
ˈfɝː.i	furry
dɪˈvɔɪd	devoid
ˈɑːbviəsli	obviously
ɪmˈbɒd.ɪ.mənt	embodiment
ˈstræŋ.ɡl̩	strangle
ˈsæn.ɪ.tər.i	sanitary
ˈmoʊʃn	motion
ˈdaɪ.nər	diner
ˌɔːrɡənəˈzeɪʃn	organization
ɪmˈplɔɪmənt	employment
ˈset.bæk	setback
əˈfɔːd	afford
ˈjuːnɪfɔːrm	uniform
dɪˈvɔːst	divorced
ˈkɒnflɪkt	conflict
frʌsˈtreɪ.tɪŋ	frustrating
rɪˈvɒlv	revolve
əˈɡoʊ	ago
feɪt	fate
tɔːr	tore
ˈmuːn.laɪt	moonlight
nəʊz	nose
ˈruːlər	ruler
ˈkɒntrɑːst	contrast
kənˈsiːd	concede
ˈneɪm.li	namely
pəˈlɪtɪkl	political
ɪˈmædʒɪnəri	imaginary
rɪˈməʊt.li	remotely
ˈliː.vər.ɪdʒ	leverage
kənˈspɪr.ə.si	conspiracy
tʃer	chair
ˈsɪɡnətʃər	signature
kənˈteɪdʒəs	contagious
ˈkɒnsəʊl	console
ˈɑː.də.tɔːr.i	auditory
pæn	pan
ɡrɑːsp	grasp
ɡʌlf	gulf
ˈbriːf.keɪs	briefcase
ɪnˈevɪtəbli	inevitably
ləʊf	loaf
ˌaʊtˈdɔːz	outdoors
ˈhaʊsˌkiː.pər	housekeeper
ɡliːm	gleam
ləˈment	lament
swɝːv	swerve
loʊd	load
ˈnætʃrəl	natural
ɪnˈfɔːm	inform
ˈɔː.θə.dɒks	orthodox
bruːm	broom
sniːz	sneeze
ˈfruːt.fəl	fruitful
məˌtɪə.ri.əˈlɪs.tɪk	materialistic
ˈfɒləʊɪŋ	following
ˈbrɪs.l̩	bristle
ˈvɜːtʃuəli	virtually
ɡreɪ	gray
ˈfaɪ.tər	fighter
əˈdɪʃənl	additional
ˈfɑː.loʊ.ɚ	follower
paɪl	pile
tʃɝːp	chirp
ˈdʒiː.ni.əl	genial
ˈætməsfɪr	atmosphere
ˈvɪzəbl	visible
rɪˈstreɪn	restrain
ˈaʊtdɔːr	outdoor
ˈreɪ.di.əs	radius
ɪˈnɑː.pɚ.tuːn	inopportune
ˈhɑː.bl̩	hobble
ˈsekʃuəl	sexual
prɪˈpeə(r)	prepare
ɡriːf	grief
ˈkʌl.prɪt	culprit
ˈprɪm.rəʊz	primrose
ˌriː.əˈʃɔːr	reassure
ˈʃʊɡər	sugar
ɪkˈskriːt	excrete
dɪˈlɪr.i.əs	delirious
rɪˈpeə(r)	repair
ˈfɪs.kəl	fiscal
ˈleɪ.si	lacy
slaɪs	slice
ˌendʒɪˈnɪr	engineer
ˈfriː.kwən.si	frequency
ˈzɪp.ər	zipper
sɪɡˈnɪfɪkənt	significant
ˈkəʊ.mə	coma
ˈmæn.li	manly
ˈfænsi	fancy
ˈɒpʃn	option
dɪsˈɡreɪs.fəl	disgraceful
stʌb	stub
ˈwaɪld.laɪf	wildlife
kliːv	cleave
rɪˈmeɪn	remain
ˈɡlɔː.ri	glory
nɪt	knit
ˈaʊt.reɪdʒ	outrage
ˈeə.ri.əl	aerial
ˈmɜː.tʃənt	merchant
ʃuː	shoe
sɔːt	sort,sought
ˈtrəʊ.fi	trophy
stɔːl	stall
ˈpæd.lɒk	padlock
bloʊt	bloat
ˈsæl.i	sally
bɪˈheɪv	behave
ˈkemɪstri	chemistry
ˌæn.ti.baɪˈɒt.ɪk	antibiotic
əˈdʌl.tər.i	adultery
dɪˈnaʊns	denounce
ˈɑːnsə(r)	answer
ˈɔːr.θə.dɑːks	orthodox
brʊk	brook
əˈplɔːd	applaud
ɪnˈsɜː.kl̩	encircle
ˈfɔːr.ə.nɚ	foreigner
praɪˈɒrəti	priority
dɑːrn	darn
ˈfəʊtəʊkɒpi	photocopy
stɪŋ	sting
ˈriː.fʌnd	refund
helm	helm
priːˌɒk.jʊˈpeɪ.ʃən	preoccupation
ˈsekəndri	secondary
ˈdef.ɪ.sɪt	deficit
ɪnˈstrʌk.tər	instructor
prɒm	prom
rɪˈspɑːnsəbl	responsible
ˌkɒn.fɪˈden.ʃəl	confidential
kənˈtend	contend
bɪˈset	beset
bləʊ	blow
bəʊl	bowl
ɪmˈbrɔɪ.dər	embroider
ˈlʊk.aʊt	lookout
ˈfɪl.mɪŋ	filming
ˌɡʊdˈbaɪ	goodbye
ɪkˈskluːd	exclude
rɪˈzem.bləns	resemblance
dɪˈkɒk.ʃən	decoction
bɑːm	bomb,balm
lɒft	loft
ˈdefɪnət	definite
dɪˈspəʊ.zəl	disposal
ˈflæt.ər	flatter
ɪnˈvɒl.ən.tər.i	involuntary
rɑːb	rob
ˌmænjuˈfæktʃərər	manufacturer
ˈbær.ən	barren
skræp	scrap
ˌprepəˈreɪʃn	preparation,preparation
ˈʃer.ɪf	sheriff
ˈprɒpə(r)	proper
ˈmɒd.ər.ət	moderate
ˈpɜː.pəs.li	purposely
rɪˈbjuːk	rebuke
refjuːˈteɪʃn	refutation
prəˈtekt	protect
bɜːθ	birth,berth,berth
stæmp	stamp
ˈentri	entry
ˈræd.ɪʃ	radish
kəˈlɪʒ.ən	collision
hɑːˈməʊ.ni.əs	harmonious
ˈɜːli	early
djuː	due,dew
ˈfeðər	feather
ˈpeɪ.stri	pastry
ˈnæn.i	nanny
soʊp	soap
ˈfeɪ.sɪŋ	facing
dɪˈvəʊ.ʃən	devotion
kəmˈpjuːtə(r)	computer
ˌveriˈeɪʃn	variation
ˌhɑːfˈweɪ	halfway
dʒeɪ	jay
tʃes	chess
ˈɡræn.ɪt	granite
dəˈrektər	director
ˈfoʊkəs	focus
ˈtelɪvɪʒn	television
ˈsæn.dɪ	sandy
ˈteknɪkl	technical
swɑːmp	swamp
ˈteɪ.sti	tasty
ˈʌðə(r)	other
ˈder.ə.lɪkt	derelict
dɪˈskriːt	discreet
əˌkɑːməˈdeɪʃn	accommodation
hɪˈstɔːrɪkl	historical
ɪˈfɪʃnt	efficient
kræm	cram
pɜːtʃ	perch
maɪn	mine
ˈkʌltʃə(r)	culture
məˈlɪɡ.nənt	malignant
ʌnˈfɪt	unfit
təʊd	toad
ˈtɒl.ər.əns	tolerance
ˈhaɪ.bə.neɪt	hibernate
raɪt	right,write,rite
ˈmentl	mental
ˈmɪnɪstə(r)	minister
ˈdʒem.ɪ.naɪ	Gemini
ˈslen.dər	slender
kɔːt	court,caught
ˈθɜːrsti	thirsty
ɪmˈpɔːtns	importance
spɪər	spear
stoʊl	stole
ɪɡˈzɒt.ɪk	exotic
ɪnˈtæŋ.ɡl̩	entangle
ˈdeɪ.laɪt	daylight
θɪk	thick
fjuː	few
ˈroʊ.teɪt	rotate
ˈkɒŋkriːt	concrete
sɝːf	surf
snuːp	snoop
ˈæn.ti.dəʊt	antidote
ˌdes.tɪˈneɪ.ʃən	destination
læŋk	lank
səˈpəʊz	suppose
ˈeɪti	eighty,eighty
ˈsædnəs	sadness
bler	blare
ɪɡˈzæktli	exactly
kwɪk	quick
ˈkɪləmiːtər	kilometre
ˈseɪ.krɪd	sacred
ˈkaʊn.tes	countess
ˌriː.prəˈdʌk.ʃən	reproduction
ˈflɪk.ər	flicker
ˈɪm.pɪ.təs	impetus
həʊl	whole,hole
səˈpres	suppress
ˈaɪðər	either
ɪnˈtaɪər	entire
ˈfeɪməs	famous
prəˈtekʃn	protection
məˈtɪriəl	material
sməʊk	smoke
ˌvedʒ.ɪˈteə.ri.ən	vegetarian
ˈmʌni	money
ˈkɒɡ.neɪt	cognate
ˌriːˈraɪt	rewrite
pɔːrt	port
ˈkaʊnsl	council
ˈlɪb.ə.ti	liberty
skoʊld	scold
ˈmæn.paʊər	manpower
ˈkreɪ.vɪŋ	craving
hɪm	him
ɡriːv	grieve
ədˈvɜː.sə.ti	adversity
prɪˈven.ʃən	prevention
vəʊɡ	vogue
sʊər	sewer
ˈmʌð.ə.hʊd	motherhood
ˈɑː.bɪ.trər.i	arbitrary
koʊlt	colt
ɪnˈreɪdʒ	enrage
ˈdɔːnt.ləs	dauntless
ˈtʌnl	tunnel
kreɪn	crane
præm	pram
ˈpaɪr.ət	pirate
ˈdæn.dɪ.laɪ.ən	dandelion
məˈkæn.ɪ.kəl	mechanical
ˈruːmə(r)	rumour
ˈenibɑːdi	anybody
ˌɪn.ɪˈfek.tɪv	ineffective
rɪˈɡɑːd.ləs	regardless
ˈkʌr.ən.si	currency
klɑːz	clause
ˈber.i	berry
ˈbaʊ.əl	bowel
rɪˈtɜːrn	return
skɪp	skip
oʊk	oak
dɪˈstɪŋɡwɪʃ	distinguish
lænd	land
hɪl	hill
spɪn	spin
ˈɔːrɡənaɪz	organize
ˈbæŋ.ɪŋ	banging
flɑːsk	flask
pərˈmɪʃn	permission
dɪˈskraɪb	describe
ˈmɒdl	model
ˌʌn.dɪˈnaɪ.ə.bl̩	undeniable
hɑːrd	hard
ˈwestən	western
ˈɡæðə(r)	gather
ɔːˈdɪʃ.ən	audition
kəˈnekt	connect
prɪˈdɪk.tə.bl̩	predictable
ˈkɑːn.stɪ.tuːt	constitute
ˈrekəɡnaɪz	recognize
ˈɔːdə(r)	order
fərˈɡɪv	forgive
ɔːlˈðəʊ	although
ˈvɪdioʊ	video
ˈrerli	rarely
sliːp	sleep
ˈɪn.set	inset
wɑːtʃ	watch
ˈeɪdʒənsi	agency
ɡrʌdʒ	grudge
kʌf	cuff
ɪnˈkəʊd	encode
pɝːt	pert
ˈhɑːspɪtl	hospital
ˈdoʊ.nɚ	donor
ˌriːkəˈnekt	reconnect
ˈdjuː.plɪ.keɪt	duplicate
poʊl	poll,pole
pɔː(r)	poor,pour
flʌd	flood
ˌaʊtˈreɪ.dʒəs	outrageous
ˈdeb.riː	debris
ˈfjuː.dəl	feudal
tʃeɪndʒ	change
spaɪk	spike
rɪˈleɪt	relate
rɪˈleɪʃn	relation
əˈkʌm.plɪʃ	accomplish
rɪə(r)	rear
əˈkʌm.pən.ɪ.mənt	accompaniment
et	ate
ˈɡɑːdn	garden
ˈɒbviəs	obvious
ˈmen.tɔːr	mentor
ˈhɒr.ɪ.bli	horribly
droʊn	drone
plʌndʒ	plunge
ˈklɜː.dʒɪ.mən	clergyman
ˈevər	ever
bɜːnt	burnt
ˈɒs.trɪtʃ	ostrich
ˈəʊpənli	openly
ˈdiː.tɔːr	detour
ɪnˈvestɪɡeɪt	investigate
ˈhəʊl.dər	holder
pɑːnd	pond
ɪnˈkjʊə.rə.bl̩	incurable
ˈsæv.i	savvy
bɪˈɡrʌdʒ	begrudge
ˈkɔː.pjʊ.lənt	corpulent
lɒst	lost
ˈkʌmftəbl	comfortable
fləʊ	flow
ˈɑːpʃn	option
ˈkʌv.ər.ɪdʒ	coverage
θrʌst	thrust
ˈbreɪ.kər	breaker
ˈluː.dɪ.krəs	ludicrous
ˈɑːnɪst	honest
ˌpɪk.tʃərˈesk	picturesque
wəʊ	woe
ˈmɪsɪŋ	missing
koʊtʃ	coach
məˈdʒɔːrəti	majority
ˈdʒuː.si	juicy
ˈswəʊlən	swollen
skiːm	scheme
ˈvɪʒn	vision
ˈrəʊ.lər	roller
vəˈleɪ	valet
ˈbjuːti	beauty
tɪp	tip
drəˈmætɪk	dramatic
ɡluː	glue
ˈɡɪv.ən	given
ˈsɪŋ.krə.naɪz	synchronize
wiːv	weave
dɪˈskwɒl.ɪ.faɪ	disqualify
wɪˈðaʊt	without
ˈbɑːtəm	bottom
ˈræpɪd	rapid
mɒk	mock
skrʌb	scrub
ˈreɪ.sɪst	racist
ˈweðər	whether,weather
ˈpraɪər	prior
ˈhæŋ.kə.tʃiːf	handkerchief
rɪˈdʌn.dən.si	redundancy
ˈdoʊ.neɪt	donate
ˈfɜː.ri	furry
ˈpɒpjələ(r)	popular
ədˈvæntɪdʒ	advantage
ˈməʊʃn	motion
sloʊp	slope
ˈmɪn.ɪ.məl	minimal
dɪˈskʌm.fət	discomfort
ˈbreɪn.ləs	brainless
ˈɡeɪt.weɪ	gateway
fæst	fast
koʊˈhɪr.əns	coherence
aɪˈden.tɪ.kəl	identical
bæmˈbuː	bamboo
dɪˈsmaʊnt	dismount
dɪˌnʌn.siˈeɪ.ʃən	denunciation
ˈjeloʊ	yellow
ˈtrɪk.i	tricky
ˈprɒspekt	prospect
ədˈmɪʃ.ən	admission
ˈlɑː.kɪt	locket
pəˈsweɪd	persuade
tiː	tea,tee
ˌɪnvɪˈteɪʃn	invitation
ˈkɒm.ən.tər.i	commentary
ˌentəˈteɪn	entertain
ˈsper.oʊ	sparrow
liːv	leave
tʃoʊz	chose
ˈlɑːdʒɪkl	logical
əˈɡresɪv	aggressive
ˈstepˌmʌð.ər	stepmother
ˈdɪm.pl̩	dimple
ˈprɑːdʒekt	project
ˈmɪstri	mystery
kɑːf	calf
bæʃ	bash
rʌf	rough
əˈpəʊz	oppose
wɔːrd	ward
ˈeɪnʃənt	ancient
θruːˈaʊt	throughout
ˈspes.ə.mɪn	specimen
kaɪˈmɪə.rə	chimera
nuːz	news
ɪkˈsplɔːrə(r)	explorer
ˈen.mɪ.ti	enmity
ɡʌm	gum
teɪl	tail,tale
ˌɪntəˈnæʃnəl	international
foʊld	fold
ˈɡrændɔːtə(r)	granddaughter
ʃeɪp	shape
dɪˈtest	detest
dwel	dwell
ˈslæn.dɚ	slander
ˈhɑː.vɚ	hover
bɑːld	bald
ˈbʌk.ɪt	bucket
ˈdɪz.i	dizzy
ˈsteɪ.ʃən.ər.i	stationery
əˈplaɪ.əns	appliance
kənˈsiː.və.bl̩	conceivable
waɪt	white
rɪˈfɜːr	refer
ˈkɪŋ.dəm	kingdom
ˈmɒd.ɪst	modest
ɪˈrʌpt	erupt
ˈwɪl.fəl	wilful
ʌnˈrest	unrest
ˈstaɪ.fl̩	stifle
hɪt	hit
ˈpɑːr.t̬ɪŋ	parting
ˈmaʊntn	mountain
ˈtʃermən	chairman
ˈriːsnt	recent
tɔːtʃ	torch
ˈsɒftweə(r)	software
ˈblæk.bɔːd	blackboard
sneɪl	snail
ˈæŋɡə(r)	anger
ˌkɒn.fɪ.den.ʃiˈæl.ɪ.ti	confidentiality
ˈmæd.ən	madden
hjuːˈmɪl.ɪ.ti	humility
ˈhɪk.ʌp	hiccup
əˈraɪvl	arrival
pɔːtʃ	porch
kjʊə(r)	cure
ˈɡɪlti	guilty
ɑːrm	arm
ˈsʌm.deɪ	someday
ˌvɑː.lənˈtɪr	volunteer
sɑːˈkæs.tɪk	sarcastic
ˈfɑːl.t̬ɚ	falter
naʊ	now
ˈɡæŋ.stər	gangster
ˈɪn.vɔɪs	invoice
ˈɒl.ɪv	olive
ʌnˈɔː.θə.raɪzd	unauthorized
ˈpjʊr.ə.t̬i	purity
pruːv	prove
læps	lapse
ˈtɪʃ.uː	tissue
ˈprɑːpərli	properly
ˈɑː.sən	arson
ˈhoʊʒ.ɚ.i	hosiery
prɪˈrɒɡ.ə.tɪv	prerogative
ˈætɪtuːd	attitude
ˈtiː.ni	teeny
ədˈmɪs.ɪ.bl̩	admissible
ɜːr	err
ˈsen.sər	censor,sensor
ɪˈrɒt.ɪk	erotic
haɪnd	hind
ˈped.əl	pedal
niːʃ	niche
ˈbɪl.bɔːd	billboard
ˈmɪdnaɪt	midnight
ˈmænɪdʒmənt	management
ˈdelɪkət	delicate
ˈkɑːmədi	comedy
ˈʃəʊ.fər	chauffeur
ˈɡɑːr.dən.ɚ	gardener
reɪs	race
ˈɡloʊbl	global
trɪm	trim
ɔːlˈbiː.ɪt	albeit
ˈɡræn.mɑː	grandma
ˈɪŋ.ɡlɪʃ	English
ˈliː.vər	lever
ˌsæl.jʊˈteɪ.ʃən	salutation
twɪt	twit
pəˈliːs	police
ˈlaɪf.staɪl	lifestyle
ˈsuː.pəˌhɪə.rəʊ	superhero
fɔːˈbeər	forbear
væn	van
reɪp	rape
sɔːr	sore
rɑːft	raft
ˈkaʊn.tə.fɪt	counterfeit
rəʊm	roam
ˈkɑːn.kɔːrs	concourse,concourse
ˈlɪm.ɪt.ləs	limitless
sɔːlt	salt
ˈdʒel.ə.tiːn	gelatine
ɪnˌθjuːziˈæstɪk	enthusiastic
ˈhəʊli	holy
lɑːrd	lard
ʌnˈnesəsəri	unnecessary
drɪft	drift
ˈhəʊp.fəl	hopeful
kənˈvɜː.tɪ.bl̩	convertible
ˈiːzi	easy
daɪˈnæm.ɪk	dynamic
ˌfɜː.ðəˈmɔːr	furthermore
sɪl	sill
ˈprɪv.ə.si	privacy
ˈsektə(r)	sector
læk	lack
relm	realm
ɪˈnɔːməs	enormous
kɔːd	cord,chord
ˈsen.səs	census
ˈdes.əl.ət	desolate
ˈpeɪ.ɡən	pagan
ɡɑːrd	guard
leɪn	lane
ˈpæsɪndʒər	passenger
ˈsekrəteri	secretary
əʊˈmɪʃ.ən	omission
strʌŋ	strung
ˈɪn.trɪ.kət	intricate
ˈpɪk.i	picky
rɪəl	real,reel
ˈwel.θi	wealthy
ˈɡrædʒuəl	gradual
ˈpraɪmeri	primary
ˈpæn.tiz	panties
sʌŋk	sunk
ˈkʌr.ənt	currant
næɡ	nag
ˈʌpˌkʌm.ɪŋ	upcoming
dɔːnt	daunt
set	set
ˈkreɪ.ɒn	crayon
ˈkɒr.əl	coral
bɒb	bob
ˈtrɪv.i.əl	trivial
hɪnt	hint
ɪnˈsep.rə.bl̩	inseparable
bɪˈliː.və.bl̩	believable
ˈmæf.i.ə	mafia
ˈkɒp.i.ər	copier
tɔːrn	torn
dʒɜːk	jerk
ˌmeɪ.əˈneɪz	mayonnaise
ɪɡˈzɪst	exist
ˈɡɔː.meɪ	gourmet
mɑːs	moss
huːp	hoop
ʌnˈlɪm.ɪ.tɪd	unlimited
ˈdʒɜːmən	German
ˈsəʊ.də	soda
stɑːv	starve
pɪˈkjuː.li.ər	peculiar
ˈspuː.ki	spooky
kənˈkluː.sɪv	conclusive
ˈtʃɝːtʃ.jɑːrd	churchyard
fɪə(r)	fear
plʌmp	plump
ˈlaɪ.ən	lion
ˈkɒn.ʃəs.nəs	consciousness
əˈkjuː.mjʊ.leɪt	accumulate
rɒt	rot
ɑːrtʃ	arch
ˈstʌdi	study
loʊ	low
ˌɒb.lɪˈɡeɪ.ʃən	obligation
rɪˈspɑːns	response
ɪnˈkʌrɪdʒ	encourage
ˈpʌnɪʃ	punish
ˌreɪ.diˈeɪ.ʃən	radiation
ðoʊz	those
ˈɡraʊnd.ləs	groundless
ˈliːdər	leader
spɔɪl	spoil
strɔː	straw
kənˈfjuːʒn	confusion
kɔˈnəʊt	connote
ˈeəriə	area
prəˈsiːd	proceed
ˌʌnɪmˈplɔɪd	unemployed
ˈkɒnsɪkwəns	consequence
wɔːd	ward
ləˈdʒɪt.ɪ.mət	legitimate
ɪkˈspləʊ.sɪv	explosive
ˈɔːr.ə.t̬ɚ	orator
ˈɪn.meɪt	inmate
ˈkɔːnə(r)	corner
ˈvʌl.nər.ə.bl̩	vulnerable
bɪˈtreɪ.əl	betrayal
kənˈstɪt.ju.ənt	constituent
ˈθɪn.ər	thinner
ˈəʊ.mən	omen
ˈdʒæɡ.jʊ.ər	jaguar
ˈkwɒlɪfaɪ	qualify
ˌɪr.ɪˈspɒn.sɪ.bl̩	irresponsible
sfɪr	sphere
ˈθreʃ.həʊld	threshold
ˌrep.ɪˈtɪʃ.ən	repetition
ˈflʌt.ər	flutter
ræm	ram
ˈsoʊ.bɚ	sober
əˈbɪtʃ.ʊə.ri	obituary
ˈmɔː.tɪ.faɪ	mortify
ˈɑː.strɪtʃ	ostrich
tɒŋz	tongs
ˈkɒl.ər	collar
əˈblɪv.i.ən	oblivion
rɪɡ	rig
dɪˈseɪ.bl̩	disable
ˈkruː.əl.ti	cruelty
ˈfruː.ɡəl	frugal
ˈdeɪtə	data
səbˈstænʃl	substantial
ˌoʊ.vɚˈtɝːn	overturn
ˈkɔː.pər.ət	corporate
ˈpɔː.trət	portrait
ˈnaɪt.klʌb	nightclub
ˈspɔː.tɪŋ	sporting
ˈtraɪ.æd	triad
kəˈpeɪ.ʃəs	capacious
faɪnd	find
ˈpɪdʒ.ən	pigeon
freɪm	frame
beɪʒ	beige
prɪˈveɪl	prevail
kuːl	cool
dɪˈstɪŋkt	distinct
ˈlaɪ.kə.bl̩	likeable
ɒpt	opt
səˈluːʃn	solution
ˈbɝː.ɡɚ	burger
ˌæk.sɪˈden.təl.i	accidentally
mʌɡ	mug
ˌsʌb.məˈriːn	submarine
ˈkɒntɪnənt	continent
ˈwʊdn	wooden
pəˈvɪl.jən	pavilion
wɜːm	worm
ˈskæn.dəl	scandal
ˈledʒ.ən.dri	legendary
ˈtʃaɪ.nə	china
ˈkɜːrənt	current
fəʊld	fold
əˈraɪv	arrive
ənˈtɪl	until
spəˈsɪfɪkli	specifically
ˌdɪsəˈɡriː	disagree
ˈloʊ.ɚ	lower
əˈtætʃt	attached
ɜːl	earl
ɪˈreɪ.zər	eraser
ˌɪn.dɪ.spen.sɪˈbɪl.ɪ.ti	indispensable
ɪɡˈzɑː.spə.reɪt	exasperate
pæd	pad
ˈsɔːr.oʊ	sorrow
ˈhɒr.ɪ.faɪd	horrified
fɒks	fox
ɪˌmæs.kjʊˈleɪ.ʃən	emasculate
mi	me
ˈhær.əs.mənt	harassment
pɑːˈtɪs.ɪ.pənt	participant
ˈlæŋ.ɡwɪʃ	languish
ˈɡɑːst.li	ghastly
ˈlɪsn	listen
ˈmaɪ.ti	mighty
ˈfɔːθˌkʌm.ɪŋ	forthcoming
fɪt	fit
ˌɪn.təˈfɪə.rəns	interference
ˈmeɪ.trɪks	matrix
ˌdɪsədˈvɑːntɪdʒ	disadvantage
ˈskiː.ər	skier
əˈmen.ə.t̬i	amenity
ˌkjʊə.riˈɒs.ɪ.ti	curiosity
ˈbræk.ɪt	bracket
krɪb	crib
ˈsker.kroʊ	scarecrow
ɪnˈfæt.ju.eɪ.tɪd	infatuated
waɪz	wise
ˈɑːbviəs	obvious
ˈsjuːmɑːkɪt	supermarket
eə(r)	air
ˈmɪl.ər	miller
ˈfɔː.fɪt	forfeit
ˈdrʌm.ər	drummer
ˈmel.əʊ	mellow
rəʊl	roll,role
pərˈfɔːrm	perform
ˈstrɔː.bər.i	strawberry
ˈeɪ.li.ən	alien
əbˈzɜːvər	observer
ˌɪn.ɪkˈspiː.di.ənt	inexpedient
həˈloʊ	hello
læmp	lamp
ɪmˈpoʊz	impose
rɪˈnjuː	renew
ˈhek.tər	hector
fɔːrˈber	forbear
rɪˈpent	repent
ˈkɑːpi	copy
rɪˈpɔːrt	report
ˈfəʊkəs	focus
ˈsʌn.ʃaɪn	sunshine
prəˈdʌk.tɪv	productive
hɑːlt	halt
ˈɡlɒs.ər.i	glossary
ˌɪnˈsaɪd	inside
səˈfɪs.tɪ.keɪ.tɪd	sophisticated
ʃæmˈpuː	shampoo
baɪnd	bind
əˈbɔːt	abort
rɪˈmem.brəns	remembrance
plɑːnt	plant
ˈstrætədʒi	strategy
ˈkemɪst	chemist
rɪˈkleɪm	reclaim
ˈevriwer	everywhere
steɪt	state
prɪk	prick
ˈsɒv.ər.ɪn	sovereign
ˌoʊ.vɚˈduː	overdue
ˈbɑː.skɪt.bɔːl	basketball
ˈtriːtmənt	treatment
ˈtæksi	taxi
naɪnθ	ninth
ˈpæs.ɪv	passive
ˈɪn.tə.kɔːs	intercourse
ˈenərdʒi	energy
ˈʃɪŋ.ɡl̩	shingle
ˈtaɪni	tiny
ˈɡɑː.lɪk	garlic
əˈpruːvl	approval
ˈves.əl	vessel
ˈmɒl.ɪ.kjuːl	molecule
ˌkɒn.əˈsɜːr	connoisseur
ˈmɑːkɪt	market
klɑːɡ	clog
ˈnæʃnəl	national
ɪˈmiːdiət	immediate
ˈriːdʒənl	regional
ˌɪn.kəmˈpliːt	incomplete
kənˈsʌlt	consult
nʊrˈɑː.t̬ɪk	neurotic
ˈdɪz.məl	dismal
edʒ	edge
ˈsɪn.θə.sɪs	synthesis
ɪnˈtɜːrprɪt	interpret
pəˈsent	percent
prəˈsiːdʒə(r)	procedure
nɪˈɡlekt	neglect
ˈməʊ.tɪ.veɪt	motivate
wɑːls	waltz
ˈmɑː.fi.ə	mafia
pɒp	pop
ˈsaɪkl	cycle
ɪˈlɒdʒ.ɪ.kəl	illogical
ˌkɒn.sʌlˈteɪ.ʃən	consultation
ˈsʌb.mə.riːn	submarine
ˌmiː.diˈəʊ.kər	mediocre
blɪŋk	blink
kəˈmɪʃn	commission
rɪˈmuːvl	removal
ˈmjuːzɪkl	musical
net	net
hʌt	hut
ˈek.əʊ	echo
ˈleə(r)	layer
ˈfel.əʊ.ʃɪp	fellowship
ˈredi	ready
pliː	plea
bɪˈniːθ	beneath
fiˈæs.kəʊ	fiasco
ˈhɔːr.frɑːst	hoarfrost
ˈpjuː.trɪ.faɪ	putrefy
ɪkˈspleɪn	explain
ɪɡˈzɔːst	exhaust
ˈɡrænfɑːðər	grandfather
ˈsæt.əl.aɪt	satellite
ʃɑːrp	sharp
ˈpɜːrpl	purple
ˈʌp.raɪt	upright
kɒd	cod
iːtʃ	each
ˈɡɑː.ɡl̩	gargle,goggle
sæɡ	sag
kəˈlɒs.əl	colossal
ˌdɪs.əˈpɪə.rəns	disappearance
kwɪd	quid
æn	an
ˈsɑː.kɪt	socket
ˈmæd.əm	madam
mɪˈsteɪkən	mistaken
ˈsəʊ.ləʊ	solo
ˈʃɪl.ɪŋ	shilling
blʌnt	blunt
ˈpɒv.ə.ti	poverty
ˈklʌt̬.ɚ	clutter
prɒd	prod
ˈben.ɪ.fæk.tər	benefactor
əʊ	owe
əˈkaʊn.tɪŋ	accounting
ˈæv.əl.ɑːnʃ	avalanche
ɪnˈtɒl.ər.ə.bl̩	intolerable
ˈkɪn.dl̩	kindle
ˌnoʊ.t̬əˈraɪ.ə.t̬i	notoriety
krɒs	cross
væt	vat
ˈnaɪ.trə.dʒən	nitrogen
ˈsæl.ɒn	salon
swiːt	sweet,suite
ˌʌpˈsterz	upstairs
ˈleɪ.zər	laser
rɪˈspekt.fəl	respectful
mɪˈskæl.kjʊ.leɪt	miscalculate
ˈɪtʃ.i	itchy
ˈplaɪ.ənt	pliant
wɜːst	worst
friːz	freeze
floʊ	flow
tʌb	tub
ˈvɪl.ən	villain
ˈɔː.di.əʊ	audio
əˈvɔɪd	avoid
blʌʃ	blush
vent	vent
ˌdʒuː.bɪˈliː	jubilee
toʊd	toad
ˌfʌndəˈmentl	fundamental
ˈstjuː.əd	steward
ɪnˈfɜː.taɪl	infertile
dɪˈter.ənt	deterrent
piːs	piece,peace
ˈbʌd.i	buddy
ˈəʊʃn	ocean
ˈdʒɑː.ki	jockey
ɪnˈheɪl	inhale
loʊð	loathe
liːst	least
rɪˈsɜːtʃ	research
splɪt	split
ˈfɑːðə(r)	father,farther
ˈwɔː.kər	walker
ˈiː.ɡər	eager
ˈhɒbi	hobby
kənˈviːn	convene
ˈduːti	duty
hʌʃ	hush
ɡæsp	gasp
θɪˈsɔː.rəs	thesaurus
aʊl	owl
proʊb	probe
ˈprɒk.si	proxy
dɪˈvaɪz	devise
ˈsɪstəm	system
ˈfjuːnərəl	funeral
prɪns	prince
rɪˈɡɑːrd	regard
stʌnt	stunt
ɡrɪl	grill
rəʊp	rope
hɪtʃ	hitch
ˈdɔːtə(r)	daughter
ˈræt.l̩	rattle
ˈprɑː.vɪns	province
ˈwɪtʃ.krɑːft	witchcraft
səˈplaɪ	supply
ˈɡəʊld.fɪʃ	goldfish
ɡoʊ	go
beɪs	base,bass
ˈwɑː.t̬ɚ.fɑːl	waterfall
wɔːrm	warm
ˈvɑːljuːm	volume
flæʃ	flash
ˈhɑː.nəs	harness
stɔːm	storm
ˈlɑːdʒli	largely
ˌnevəðəˈles	nevertheless
spɪl	spill
θiːm	theme
ˈkæn.did	candied
ˈhɒspɪtl	hospital
ˈsɑː.sɪdʒ	sausage
ˈpʌz.l̩.mənt	puzzlement
ˈsentɪmiːtər	centimetre
piː	pee,pea
ˈkɒnstəntli	constantly
ˈkɑː.mɝːs	commerce
ˈleɪ.dl̩	ladle
dɪˈlɪbərətli	deliberately
snætʃ	snatch
dɪˈfen.dər	defender
ˈpæt.ri.ət	patriot
hɔːrd	hoard
ˈkælərɪ	calory
ˈmɝː.mɚ	murmur
ˌkəʊ.ɪˈfɪʃ.ənt	coefficient
ˈfet.ɪd	fetid
ˈliːdɪŋ	leading
vəˈkæbjələri	vocabulary
ˈem.bri.əʊ	embryo
nɔː	gnaw
raɪs	rice
həz	has
briːtʃ	breach
ˈten.dən	tendon
ˈspæn.ər	spanner
ɪɡˈzɑːmpl	example
ˈnɔɪz.ləs	noiseless
ˈprɪti	pretty
ˈsɪv.ɪk	civic
ˈɔːfn	often
ˌəʊ.vəˈnaɪt	overnight
stɑːˈveɪ.ʃən	starvation
ˈaʊə(r)	hour
ˈwɪnər	winner
ˈsɑːmpl	sample
ˈtjuː.nə	tuna
dɪˈpləʊ.mə	diploma
ðəmˈselvz	themselves
ˈtek.nɪ.kəl.i	technically
rɪˈkwaɪərmənt	requirement
ˈkoʊ.vɝːt	covert
speɪd	spade
ˈpæl.ər	pallor
mɪkst	mixed
braʊn	brown
kluː	clue
ɡʊdz	goods
ˈhɑː.vɪst	harvest
əˈsæs.ɪn	assassin
stɑː(r)	star
snɑːrl	snarl
daɪk	dike
ˈdɪf.ɪ.dənt	diffident
ˈwɔːr.fer	warfare
rɪˈpres	repress
əˈtɜːrni	attorney
əˈθɔːrəti	authority
ɪˈkwɪpmənt	equipment
ˈspæn.ɪʃ	Spanish
dɒk	dock
daɪˈɡres	digress
lɑːns	lance
ˈlænd.lɔːd	landlord
ɪmˈpeɪʃnt	impatient
roʊm	roam
ˈkɪn.dəˌɡɑː.tən	kindergarten
ˈrɒk.ɪt	rocket
ɪnˈdʌstriəl	industrial
ˈlɑːf.tər	laughter
dʒɒɡ	jog
ˈæmbjələns	ambulance
ˈmaʊntən	mountain
ˈkwɑːlɪfaɪd	qualified
mɒp	mop
ˈleɪ.dən	laden
ˈnɔː.tɪ.kəl	nautical
ˈhaɪə(r)	hire
ˈheɪl.stəʊn	hailstone
ˈɡrænmʌðə(r)	grandmother
dɑːl	doll
ˌeɪˈtiːn	eighteen
ˈnɒvl	novel
pəˈpleks	perplex
red	red
dɪˈlɪvər	deliver
ɪˈlæs.tɪk	elastic
ɪkˈspen.dɪ.tʃər	expenditure
ˌɪn.dɪˈskriːt	indiscreet
laɪt	light
ˈmɝː.dɚ.ɚ	murderer
ˈmɑːdərn	modern
deɪl	dale
skeəs	scarce
ˈemp.ti.nəs	emptiness
ˈɡɔː.dʒəs	gorgeous
ˈkɑːtɪdʒ	cottage
ˈter.ə.rɪ.zəm	terrorism
ˈkɒm.ɪt	comet
fɔːdʒ	forge
ˈkʊk.ər.i	cookery
kənˈteɪn	contain
ˈjuːsfl	useful
rɪˈdʌkʃn	reduction
sɑːb	sob
bɝːp	burp
ɪmˈprɪz.ən	imprison
ˌɒs.tenˈteɪ.ʃəs	ostentatious
ˈməʊstli	mostly
pɑːʃ	posh
sɪnˈsɪə(r)	sincere
ˈvel.vɪt	velvet
ˌəʊ.vəˈhɪər	overhear
sɑːd	sod
stɑːp	stop
ˈkɒm.ən.pleɪs	commonplace
ˌspek.jʊˈleɪ.ʃən	speculation
ˈsɒl.əm	solemn
stɑːl	stall
hʊˈreɪ	hooray
ˈres.lɪŋ	wrestling
ˈθer.ə.pɪst	therapist
skɜːrt	skirt
ˈvɜː.səs	versus
ræʃ	rash
dɪˈstɪl	distil
ˈwɒlɪt	wallet
hem	hem
ˈmʌl.tɪ.pl̩	multiple
ˈlɔɪ.tər.ɪŋ	loitering
ˈdaɪ.vɪŋ	diving
daɪˈlem.ə	dilemma
kəˈrek.ʃən	correction
hʊd	hood
ˈæs.pɪ.rɪn	aspirin
ˈbeə.fʊt	barefoot
ˈrɪdʒ.ɪd	rigid
bɪˈfrend	befriend
preɪ	pray,prey
pɪŋk	pink
ˈjɪə.bʊk	yearbook
ˈdjʊə.rə.bl̩	durable
per	pair,pear,pare
treɪd	trade
ˈfeloʊ	fellow
kɒk	cock
ˈpʌb.lɪ.kli	publicly
ˈmeɪ.pl̩	maple
ˈmɪm.ɪk	mimic
ˈtʃɑːklət	chocolate
kəmˈpʌl.ʃən	compulsion
ˈæl.ə.keɪt	allocate
saɪd	side
siːld	sealed
ɪnˈɡriːdiənt	ingredient
wed	wed
ˈɡreɪs.ləs	graceless
brænd	brand
ˌek.sɪˈkjuː.ʃən	execution
ˈtʃɪm.ni	chimney
ˈrɪd.ɪ.kjuːl	ridicule
ˈædʒ.ek.tɪv	adjective
ˈstres.fəl	stressful
ˈluː.mɪ.nəs	luminous
kweɪl	quail
ɪnˈdɪdʒ.ɪ.nəs	indigenous
ˈfɔːmə(r)	former
ˌɪn.təˈfɪər	interfere
njuːˈtrɪʃ.ən	nutrition
ˈləʊ.nər	loner
ˈhɑːd.ʃɪp	hardship
ˈstjuːdnt	student
klɪp	clip
bɑːrdʒ	barge
ˈfɔː.rəm	forum
paɪ	pie
ˈsætɪsfaɪ	satisfy
ˈdel.ɪ.kə.si	delicacy
haɪ	high
ˈenədʒi	energy
ˈpoʊ.t̬ənt	potent
ɪkˈsplɔːrər	explorer
rɪft	rift
ɪɡˈzem.plɑːr	exemplar
ðoʊ	though
kəˈlæt.ər.əl	collateral
ɪmˈplɔɪiː	employee
paɪp	pipe
ˈhaɪə.rɪŋ	hiring
ˈfaɪə.pleɪs	fireplace
ɡroʊs	gross
səbˈskraɪb	subscribe
ɪnˈkɒm.pɪ.tənt	incompetent
ɪˈmuː.və.bl̩	immovable
ˌdaʊnˈtaʊn	downtown
senˈseɪ.ʃən	sensation
mʊˈstɑːʃ	moustache
ˈɡɑː.nɪʃ	garnish
nɔːt	nought
əˈtest	attest
ˈvɪd.i.əʊ.teɪp	videotape
hɪˈleə.ri.əs	hilarious
fæsˈtɪd.i.əs	fastidious
jæp	yap
əˈblɪt.ər.eɪt	obliterate
ɡʊd	good
sɒft	soft
briːf	brief
ˈmaʊn.tɪd	mounted
dɪˈspliːz	displease
ˈæb.nɪ.ɡeɪt	abnegate
səʊld	sold
əʃɔː(r)	assure
ˈɪntərnet	internet
wɜːrd	word
ɪnˈtɪriər	interior
ˈəʊ.və.hed	overhead
ˌriːˈʃed.juːl	reschedule
pɪntʃ	pinch
ɪmˈpreʃn	impression
suːˈpɪəriə(r)	superior
ˈfren.zi	frenzy
ˈæd.mɪ.rə.bl̩	admirable
ˈæɡ.rə.veɪt	aggravate
dɪˈpɑːtʃə(r)	departure
drɔːr	drawer
pɝːk	perk
ˈsjuːtəbl	suitable
ˈpɑː.sən	parson
kɪl	kill
ˈriː.dʒənt	regent
ˈbɪɡ.ət	bigot
neɪl	nail
ˈkæl.kjʊ.leɪ.tər	calculator
pɜːs	purse
ˈstæɡ.ər	stagger
ˈkəʊ.kəʊ	cocoa
ɪnˈtɪəriə(r)	interior
bɪˈliːv	believe
ˈtæblət	tablet
vɑːlt	vault
ˈpɜːvɜːt	pervert
ˈkɪt.ən	kitten
dʒɝːk	jerk
stəˈbɪl.ɪ.ti	stability
fɔːr	four,fore
ˌdɪp.ləˈmæt.ɪk	diplomatic
ˈfɑː.li	folly
snɔːrt	snort
ˌrɪəˈlɪstɪk	realistic
peɡ	peg
ˈspeʃl	special
krɑːp	crop
rəʊˈmæntɪk	romantic
lʌŋ	lung
ˈbiːt.ruːt	beetroot
ˌelsˈweə(r)	elsewhere
seɪnt	saint
ˈkɑː.ɡəʊ	cargo
ˈvælɪd	valid
ˈtrɔː.mə.taɪz	traumatize
kruːˈseɪd	crusade
ˈes.pi.ə.nɑːʒ	espionage
stɪl	still
ˈdʒɪp.si	gypsy
ˈpredʒ.ʊ.dɪs	prejudice
rɪˈdres	redress
wɜːθ	worth
ˈwɜːrkər	worker
ˌsek.sjuˈæl.ɪ.ti	sexuality
ˈmɑː.tər	martyr
ˈteɪbl	table
ˈrev.ən.juː	revenue
ˈklɒk.waɪz	clockwise
ɪˈmɒrəl	immoral
ˈplenɪtjuːd	plenitude
sɜːrv	serve
ˈfeləʊ	fellow
tʃɑːp	chop
ˈmiː.nɪŋ.fəl	meaningful
ɡrəʊv	grove
ˈmek.ə.nɪ.zəm	mechanism
ˌdɪsˈlɔɪ.əl	disloyal
noʊt	note
zuːm	zoom
ˌfɑː.rəˈweɪ	faraway
ˈer.ənd	errand
fɒɡ	fog
tʌk	tuck
ˈsɑː.lə.ter.i	solitary
ˈmeɪ.ni.æk	maniac
ˈleɡ.ə.si	legacy
fɝːn	fern
fɜːst	first
ˈder.ɪŋ	daring
ˌriː.pəˈkʌʃ.ən	repercussion
ˌməʊ.mənˈter.ɪ.li	momentarily
bɪˈdev.əl	bedevil
ˈtʃeɪndʒ.ləs	changeless
ˈdrɔːɪŋ	drawing
pɚˈspaɪɚ	perspire
ˈdʒenrəli	generally
ˈkɔː.ʃəs	cautious
ɪnˈlɑːdʒ	enlarge
ˈɪnkwəri	enquiry
ˈfæk.əl.ti	faculty
spliːn	spleen
koʊl	coal
rɪˈwɔːd	reward
ˈkɒn.trə.vɜː.si	controversy
pəˈten.ʃəl.i	potentially
ˈnɒm.ɪ.nəl	nominal
dɪˈtes.tə.bl̩	detestable
ˈnʌmbə(r)	number
ˈweɪtə(r)	waiter
ˈhɔːs.bæk	horseback
fɪˈzɪʃ.ən	physician
ɔːˈster.ɪ.ti	austerity
ˈhɜːt.fəl	hurtful
ˈdaɪɪŋ	dying
ɪmˈpruːv	improve
ˈmɪəli	merely
ˈpɪs.təl	pistol
ɪkˈstræk.ʃən	extraction
ˈfraɪdeɪ	Friday
ˈkɑːntræst	contrast
dʒɑːɡ	jog
ɪˈnɒp.ə.tjuːn	inopportune
ˈdæm.ɪdʒd	damaged
prɪˈzjuːməbli	presumably
ˈriːdə(r)	reader
ɪˈlɪt.ər.ət	illiterate
trʌk	truck
ˈves.tɪdʒ	vestige
ˈeɪm.ləs	aimless
əˈweə(r)	aware
spaɪ	spy
ˈhɒs.tɪdʒ	hostage
spɑː	spa
ˈdɪs.tənt	distant
ˈpreɡnənt	pregnant
ˌʌnˈləʊd	unload
ˈhændgrɪp	handgrip
ˈspɪrɪtʃuəl	spiritual
əˈmaʊnt	amount
tʊə(r)	tour
ˈoʊʃn	ocean
bʌt	butt
raɪm	rhyme
ˈpæd.l̩	paddle
ˈprɑːbəbli	probably
kənˈvɪk.ʃən	conviction
ɪkˈspel	expel
ɪnˈθjuːziæzəm	enthusiasm
veɪl	veil
ˈplæt.ɪ.nəm	platinum
ləʊð	loathe
ˌsætɪsˈfækʃn	satisfaction
həd	had
ˈrɒt.ən	rotten
ˈnəʊ.tə.bli	notably
ˈmʌd.i	muddy
ˈpɑː.lə.t̬i	polity
tekˈnɑːlədʒi	technology
ˈrɑː.tən	rotten
rɪˈzɪst	resist
ʌnˈfɔːtʃənət	unfortunate
ˈtaɪ.ɡər	tiger
ˈwestərn	western
ˈwuːndɪd	wounded
ˌɡrædʒ.uˈeɪ.ʃən	graduation
ˈbɒs.i	bossy
daɪˈdʒes.tʃən	digestion
liːtʃ	leech
rɪˈlʌk.təns	reluctance,reluctance
ɡəʊ	go
ˈpæt̬.i.oʊ	patio
ɪˈnes.tɪ.mə.bl̩	inestimable
pəˈren.təl	parental
ˌpɜː.pənˈdɪk.jʊ.lər	perpendicular
ˈprɒdʌkt	product
nəʊˈtɔː.ri.əs	notorious
ˈtær.ɪf	tariff
ˈlɪv.ər	liver
ˈtemprəri	temporary
skɜːt	skirt
ˈhʌr.ɪ.kən	hurricane
maɪld	mild
ˈprɒdʒekt	project
ˈmɑː.mə.leɪd	marmalade
ʌnˈtaɪ	untie
ˈprɒf.ə.si	prophecy
ˈæl.ɪ.mə.ni	alimony
ˈaʊt.bɜːst	outburst
əˈloʊn	alone
tekst	text
ˈsʌb.weɪ	subway
ˈwɒtʃ.ər	watcher
rɪˈpiː.tɪd.li	repeatedly
ˈaɪ.lɪd	eyelid
flæks	flax
kɪd	kid
ˌɡræv.ɪˈteɪ.ʃən	gravitation
biːf	beef
ˈkɔːkɪ	corky
aɪˈdiːə	idea
wɒz	was
ˈmes.i	messy
spɜːm	sperm
foʊm	foam
nəʊˈbɪl.ə.ti	nobility
dɪsˈɡʌst	disgust
dʒʌst	just
wɪn	win
ˈəʊ.nə.ʃɪp	ownership
ˈvaɪrəs	virus
kəˈlekt	collect
ˈɪnkʌm	income
meɪ	may,May
dɪˈrɪv.ə.tɪv	derivative
ˌæb.əˈrɪdʒ.ɪ.nəl	aboriginal
ˌmɪsˈhæn.dəl	mishandle
ˈpɑː.kɪŋ	parking
ˈsaɪ.nɪŋ	signing
ˈhɑːt.biːt	heartbeat
ˌɪl.əˈstreɪ.ʃən	illustration
ˈɑː.mə.lət	omelette
sɪˈdeɪt	sedate
stɑːt	start
ˈwɜːk.pleɪs	workplace
əˈpen.dɪks	appendix
ruːˈtiːn	routine
pəˈsiːv	perceive
ˈfaɪ.rɪŋ	firing
freɪl	frail
ɡæŋ	gang
ɪkˈspres	express
əˈdres	address
bʌm	bum
ˈpɪk.nɪk	picnic
ˈdʒel.ə.si	jealousy
hæŋk	hank
ˈskrɪb.l̩	scribble
drʌɡ	drug
ˈkɒlɪdʒ	college
təˈmɑːtəʊ	tomato
mɒb	mob
ˈprɒs.ɪ.kjuːt	prosecute
ɪnˈstɔːl.mənt	instalment
ˈpriː.mi.əm	premium
breɪk	break,brake
ˈær.ɪd	arid
rəʊv	rove
ˈfeɪθ.ləs	faithless
ˈbɒd.ɪ.li	bodily
ˌɔːltəˈɡeðə(r)	altogether
ˈmæɡ.paɪ	magpie
bɪn	bin,been
ˈtʃaɪld.hʊd	childhood
prɪˈzɜːv	preserve
wenˈevər	whenever
maʊnt	mount
tʌsk	tusk
ˌɪd.iˈɒt.ɪk	idiotic
ˈwelkəm	welcome
ˈædvətaɪzɪŋ	advertising
ʌnˈkʌv.ər	uncover
ˈplæstɪk	plastic
ˈprɒm.ɪ.sɪŋ	promising
oʊˈbɪtʃ.u.er.i	obituary
rɪˈteɪ.nər	retainer
ˈkoʊ.hɔːrt	cohort
ˈbəʊ.nəs	bonus
ɡrəʊ	grow
ˈmɑːdl	model
tʃɪl	chill
sɔɪl	soil
əˈpɒs.l̩	apostle
ɪnˈdɔːs.mənt	endorsement
peɪ	pay
tʃiːp	cheap
ˈɑː.nə.rer.i	honorary
ˈvɪn.ɪ.ɡər	vinegar
ˈpɑː.sə.bl̩	passable
rɪˈmaɪnd	remind
ˈkɑːment	comment
ˈdrɪv.ən	driven
ɪnˈsɪn.ju.eɪt	insinuate
ˌdɪs.əˈreɪ	disarray
ɪˈledʒ.ə.bl̩	illegible
fəˈmɪliər	familiar
kənˈstrʌkt	construct
æmˈbɪʃn	ambition
ˈstæt.ɪk	static
kræɡ	crag
əˈpɪə(r)	appear
ˈæksɪdənt	accident
ˈsɪtɪzn	citizen
ˈpjʊrli	purely
ɪˈmæs.kjʊ.leɪt	emasculate
ˈpaʊə(r)	power
ˌɪn.ɪkˈstrɪk.ə.bl̩	inextricable
ʌnˈfɔːrtʃənət	unfortunate
ˌɪn.kənˈsiː.və.bl̩	inconceivable
əˈbiː.di.əns	obedience
ɡrɑːnt	grant
pʊʃ	push
sɪŋ	sing
ˈvaɪələns	violence
ˈkriːtʃər	creature
sɜː(r)	sir
ˈsɪmələr	similar
dɪˈsembə(r)	December
freɪt	freight
ˈmaɪn.dər	minder
ˈsɒri	sorry
ˈəʊpnɪŋ	opening
əˈpɒl.ə.dʒi	apology
ˈmeθəd	method
rɪˈlæps	relapse,relapse
ɪmˈpet.ju.əs	impetuous
ˈwedɪŋ	wedding
dʒoʊk	joke
tiːtʃ	teach
səʊp	soap
dɪˌtɜːrmɪˈneɪʃn	determination
ˈɪn.tɪ.mət	intimate
dɪˈveləp	develop
ˈfɝː.t̬əl	fertile
biːt	beat
ədˈmaɪə.rər	admirer
pəˈkʌs.ɪv	percussive
ˌkɒn.stəˈneɪ.ʃən	consternation
ɪˈveɪd	evade
ˈkʌn.ɪŋ	cunning
ˌɑːpəˈzɪʃn	opposition
ˈeə.pleɪn	airplane
ˈmɪt.ən	mitten
ˈstʌt.ər	stutter
ɪˈned.ɪ.bl̩	inedible
ˈpræktɪs	practice,practise
dɪˈvaɪd	divide
ˈɡləʊ.ɪŋ	glowing
ˌdiːˈfrɒst	defrost
ˈsaɪd.laɪn	sideline
ˈmet̬.ə.fɔːr	metaphor
ˈsiːzn	season
ˌprep.əˈzɪʃ.ən	preposition
hɔːn	horn
ˈrʌbər	rubber
səˈdʒestʃən	suggestion
dɪsˈɒnɪst	dishonest
ˈhɑːn.t̬ɪŋ	haunting
ɑːnt	aunt
ˈflʌt̬.ɚ	flutter
kəˈθiː.drəl	cathedral
ɪmˈpɔːrt	import
ˈpɪktʃə(r)	picture
ˈhɪstri	history
ˈθɜːrti	thirty
siːn	scene
ʌnˈjuːʒuəl	unusual
fjuːz	fuse
ˌel.ɪˈmen.tər.i	elementary
ˈtʃɪl.drən	children
ˈet.ɪ.ket	etiquette
ˈɔːrdneri	ordinary
splæʃ	splash
ˈen.vɔɪ	envoy
noʊz	nose
ˈsuːtəbl	suitable
steɪl	stale
ˌɪndɪˈpendəns	independence
ˈɪn.tər.ɪm	interim
ˈsɜː.mən	sermon
əbˈsen.ɪ.ti	obscenity
pəˈruːz	peruse
ˌoʊ.vɚˈloʊd	overload
ˈbæp.tɪ.zəm	baptism
ˌɪn.təˈsept	intercept
səkˈsiːd	succeed
læb	lab
θwɔːrt	thwart
ˌʌn.bɪˈliː.və.bl̩	unbelievable
brɒnz	bronze
ˈmʌl.bər.i	mulberry
stiːd	steed
tʃoʊk	choke
rɪˈzɔːs	resource
ˈspek.tɪ.kl̩	spectacle
ˈkʌstəmər	customer
dɪˈfen.dənt	defendant
kənˈfaɪd	confide
ˈspəʊkən	spoken
əˈsɒlt	assault
kruːz	cruise
ˈnɑː.strəl	nostril
ˈbriː.fɪŋ	briefing
ˈskep.tɪ.kəl	sceptical
ðæt	that
ˈmedɪkl	medical
ˈɔɪnt.mənt	ointment
ˈɡreɪtli	greatly
ˈlɪtrətʃə(r)	literature
rɪˈmɑːkəbl	remarkable
klæʃ	clash
ˈsɪt.ɪŋ	sitting
ɡaɪl	guile
ɪnˈveə.ri.ə.bl̩	invariable
ˈkrʊk.ɪd	crooked
ˈbeɪ.kər	baker
ˈher.i	hairy
slæp	slap
ˈrek.ən.saɪl	reconcile
dɪsˈfɪɡ.ər	disfigure
rer	rare
ɪˈlɪs.ɪt	illicit
ɪɡˈzæm.ɪ.nər	examiner
ˈsʌdn	sudden
ɪnˈɡeɪdʒ	engage
dɪʃ	dish
ˈnɑːnsens	nonsense
ˈsetʌp	setup
əˈbriː.vi.eɪt	abbreviate
ənd	and
skɑːld	scald
ˈmaɪl.stəʊn	milestone
ˈhɑːmləs	harmless
pledʒ	pledge
ˈrʊrəl	rural
ˈfeɪ.vər.ə.bl̩	favourable
dʒiˈɒm.ə.tri	geometry
daɪn	dine
dɪˈpɪkt	depict
reɪdʒ	rage
klɪk	click
tʃɒp	chop
θʌɡ	thug
ˈbriː.dɪŋ	breeding
əˈpriːʃieɪt	appreciate
ɪɡˌzæmɪˈneɪʃn	examination
ˈpɔː.rəs	porous
flaɪ	fly
toʊst	toast
əˌkɒməˈdeɪʃn	accommodation
ˌriːˈkɑːst	recast
broʊk	broke
səˈlɑːn	salon
ˈfɔːs.fəl	forceful
heɪl	hail
ˈɡɑːbɪdʒ	garbage
ˌʌn.dəˈres.tɪ.meɪt	underestimate
ˈpɑː.ʃəl	partial
əˈlaʊ.əns	allowance
ɪnˈspaɪə.rɪŋ	inspiring
bek	beck
ˈpɒt.ər	potter
ˈtenʃn	tension
tɜːrn	turn
strəʊk	stroke
ɪˈnɔːrməs	enormous
ˈvɑː.lən.ter.i	voluntary
feɪs	face
rɪˈlʌk.tənt	reluctant
ˈsev.ər	sever
fæd	fad
ˈɑːb.dʊr.ɪt	obdurate
kæsk	cask
ˈkɔːn.flaʊ.ər	cornflower
ˌpɜː.spərˈeɪ.ʃən	perspiration
fæn	fan
əˈkrɔːs	across
əˈpɔɪntmənt	appointment
ˈsəʊl.dər	solder
kɪs	kiss
kəmˈpjuːt	compute
bætʃ	batch
ˈmænˌslɔː.tər	manslaughter
ˈbɒk.sər	boxer
ˈflʌd.ɪŋ	flooding
lʌɡˈʒʊə.ri.ənt	luxuriant
ˈtɔː.tʃər	torture
ˈleɪbə(r)	labour
proʊ	pro
ɡræsp	grasp
ʃeɪd	shade
ˈher.ɪŋ	herring
ˈek.ses	excess
dɔːɡ	dog
ˈneɪkɪd	naked
saɪt	sight,site
ˈpɑːləmənt	parliament
ˈfjuːəl	fuel
ˈfʌŋkʃn	function
ˈmed.əl	medal
saɪn	sign
ˈdɑː.li	dolly
ˈræb.l̩	rabble
ˈkoʊ.lən	colon
ˈæŋ.ɡjʊ.lər	angular
ˈlɒz.ɪndʒ	lozenge
əˌsəʊʃiˈeɪʃn	association
prɪˈzɜːrv	preserve
ʌpˈsetɪŋ	upsetting
ˈhæmˌbɜː.ɡər	hamburger
flɝːt	flirt
ˈmelt.daʊn	meltdown
ˈaɪ.kɒn	icon
prɪˈfɜː(r)	prefer
ræft	raft
daɪˈleɪt	dilate
stɒp	stop
kəˈres	caress
ˈɡrəʊ.sər	grocer
ˈbeɪsɪk	basic
ˈkriːtʃə(r)	creature
ˈfɔːt.naɪt	fortnight
ˈper.ən.t̬ɪŋ	parenting
ˈstɪn.dʒi	stingy
fɔːˈmɪ.də.bl̩	formidable
ˈhedfəʊn	headphone
ˈækjərət	accurate
kɔːs	course,coarse
rɪˈɡɑːd	regard
ˌwɜːldˈwaɪd	worldwide
ˈsɪl.ə.bl̩	syllable
wʌn	one,won
ˈpaʊəfl	powerful
ˈkɑːŋɡrəs	congress
kəʊˌɒp.ərˈeɪ.ʃən	cooperation
ˈskæt̬.ɚ	scatter
ˈkluː.ləs	clueless
ɪkˈskjuːs	excuse
ˈsensətɪv	sensitive
prəˈvaɪd	provide
ˈsɜːrveɪ	survey
ræɡ	rag
ˈheɪ.vən	haven
ˌɪn.əkˈses.ɪ.bl̩	inaccessible
ˌoʊ.vɚˈreɪ.t̬ɪd	overrated
rɪd	rid
ˈed.ɪt	edit
presˈtiːʒ	prestige
ˌʌndəˈwɔːtə(r)	underwater
smɪr	smear
ˈtæk.tɪ.kəl	tactical
ˈjuːzə(r)	user
ˈmɔːnɪŋ	morning
əˈbɪləti	ability
ˈæktər	actor
ˈkɑːnfɪdənt	confident
ɔːlˈtɜːrnətɪv	alternative
ˈtɒk.sɪk	toxic
skrəʊl	scroll
ɪnˈdʒɔɪ	enjoy
rɪˈhɜːs	rehearse
ˈpɔː.təl	portal
əˈluːd	allude
ˈsketʃ.i	sketchy
bɪˈnaɪn	benign
ɪkˈsepʃn	exception
ˌrez.əˈluː.ʃən	resolution
ˈhæn.dɪ.krɑːft	handicraft
ˈneɪ.bəl.i	neighbourly
suːp	soup
dʒɑːr	jar
ɪˈrel.ɪ.vənt	irrelevant
ˈprɪznə(r)	prisoner
blɒk	block
kəˈreɪ.dʒəs	courageous
biːm	beam
sʌm	sum
ˈʃɔːt.kʌt	shortcut
ˈəʊ.nər.əs	onerous
ədˈmɪt	admit
fɑːks	fox
traɪb	tribe
maɪs	mice
ˈdrɪz.əl	drizzle
əˈbeɪt	abate
ˈɑː.dju.əs	arduous
diːm	deem
laɪf	life
ˈmembə(r)	member
ˈtɑːrɡɪt	target
ˈɡædʒ.ɪt	gadget
ˈrɪəli	really
krɔːs	cross
ɪnˈsɪst	insist
ˈfʊt.prɪnt	footprint
ɡræb	grab
ˈsɪɡnəl	signal
ˈeɪ.prɪ.kɒt	apricot
buːb	boob
prəˈhɪb.ɪt	prohibit
məst	must
kɪn	kin
ˈɒb.lɒŋ	oblong
pɝːdʒ	purge
ˈtaɪər	tyre,tire
ʌnˈwaɪnd	unwind
bɒɡ	bog
fiː	fee
ˌkɑːmbɪˈneɪʃn	combination
tʃəʊk	choke
ɪkˈspæn.ʃən	expansion
əˈkaʊn.tənt	accountant
ˌnɒt.wɪðˈstæn.dɪŋ	notwithstanding
sker	scare
ˈræl.i	rally
ˈsɪmp.təm	symptom
ˌʌn.əˈweər	unaware
əˌlɒŋˈsaɪd	alongside
tend	tend
əˈkeɪ.ʒən.əl	occasional
prɑːd	prod
ˈθɜːroʊ	thorough
ˈɔː.səm	awesome
ˈkwɒləti	quality
ˈɪn.stənt	instant
ˈɡlæm.ər.əs	glamorous
ˈiː.stər	Easter
seɪdʒ	sage
ˈræs.kəl	rascal
tʃɜːrtʃ	church
ˌprəʊ.ɪˈbɪʃ.ən	prohibition
ˈek.sɪ.kjuːt	execute
ˌdekəˈreɪʃn	decoration
ˈmɪsˌkær.ɪdʒ	miscarriage
ˈluːk.wɔːm	lukewarm
əˈsɔːt.mənt	assortment
ˈpaɪə.t̬i	piety
ˈbʊl.i	bully
sɪft	sift
ˈaʊt.leɪ	outlay
ˌɪn.təˈsek.ʃən	intersection
ˌsen.sɪˈtɪv.ɪ.ti	sensitivity
dʒuːˈdɪʃ.əl	judicial,judicial
ˈpɜːsənl	personal
ˈprəʊtest	protest
ˈrʌd.ər	rudder
ˈwɪtnəs	witness
spɔːt	sport
ˈkætəɡɔːri	category
ˈɜːbən	urban
ˈpeɪnˌkɪl.ər	painkiller
kənˈfɜːr	confer
ɡɪld	gild
ˈkæp.rɪ.kɔːn	Capricorn
ɒn	on
vɪˈveɪ.ʃəs	vivacious
ˈherdresər	hairdresser
ˈɡaɪ.dəns	guidance
ˌprɒb.əˈbɪl.ɪ.ti	probability
dɪsˈlaɪk	dislike
ˈhɑːt.breɪk	heartbreak
ˌentərˈteɪnmənt	entertainment
rɪˈstrɪkʃn	restriction
dɪˈfen.sɪv	defensive
ˌpɒpjuˈleɪʃn	population
pɪr	peer,pier
ˌentəˈteɪnɪŋ	entertaining
əkˈses.ər.i	accessory
dɪˈpend	depend
ˌpɔːtˈfəʊ.li.əʊ	portfolio
rɪm	rim
spæm	spam
ˈbeɪ.kər.i	bakery
məʊl	mole
ˈep.ɪ.səʊd	episode
ˈmiːn.taɪm	meantime
ˈætrɪbjuːt	attribute
kənˈkɜːr	concur,concur,concur
ɡes	guess
ˈprefrəns	preference
pəˈlaɪt	polite
trænˈsplɑːnt	transplant
tɔː(r)	tour
ˈsɜːtn	certain
əˈprɑːksɪmətli	approximately
ˈjʌm.i	yummy
ˈsɪr.əm	serum
buːst	boost
ˈsəʊ.ʃə.bl̩	sociable
swɔːm	swarm
ˈlɔːjə(r)	lawyer
ˌwɒt.səʊˈev.ər	whatsoever
ˈkʌltʃər	culture
ɪnˈveɪ.ʒən	invasion
ɡeɪl	gale
ˈɪnstɪtuːt	institute
kənˈdɪʃn	condition
ˈmɔːr.ɑːn	moron
ˈsɜːneɪm	surname
ɡəˈrɪl.ə	gorilla
ˌʌn.aɪˈden.tɪ.faɪd	unidentified
ˈæm.bər	amber
kənˈsuːmər	consumer
luː	loo
ˌrek.ənˌsɪl.iˈeɪ.ʃən	reconciliation
ˈhɪrɪŋ	hearing
ˈkwɒlɪfaɪd	qualified
əʊk	oak
ˌkwɑːlɪfɪˈkeɪʃn	qualification
kənˈtrɪbjuːt	contribute
ˈdaʊn.ləʊd	download
ɪkˈspaɪər	expire
ˈfedərəl	federal
klɜːrk	clerk
wiːt	wheat
əˈniː.mi.ə	anaemia
ˈseɡ.mənt	segment
ˈret.ɪ.njuː	retinue
ˈæf.tɚ.θɑːt	afterthought
lɜːn	learn
kənˈfes	confess
swel	swell
ˈkɑː.sɪk	carsick
ˈɪntəvjuː	interview
kənˈvɪn.sɪŋ	convincing
ˈskɑː.lɚ	scholar
doʊs	dose
kænˈtiːn	canteen
tɑːrt	tart
dʌv	dove
əˈtəʊn.mənt	atonement
ˈlɑː.zəndʒ	lozenge
æmˈbɪʃ.əs	ambitious
ræp	wrap,rap
ˈfjʊə.ri.əs	furious
ˈbɑːɡən	bargain
ˈter.ə.faɪ.ɪŋ	terrifying
ˈplɑː.stər	plaster
ˈvɪdʒ.ɪ.ləns	vigilance
ɡlaɪd	glide
dɪˈzɜːrv	deserve
ˌsaɪ.kəlˈɒdʒ.ɪ.kəl	psychological
wɒnd	wand
ɪnˈfɪə.ri.ər	inferior
ɪˈræt.ɪk	erratic
dɪˈstrɔɪ	destroy
ˈwaɪ.dən	widen
griːs	Greece
ˈfuːl.pruːf	foolproof
stʌmp	stump
ɪnˈflæm.ə.bl̩	inflammable
ˌɪn.sɪˈkjʊər	insecure
buːθ	booth
ˈdaɪ.əl	dial
ˈtəʊ.kən	token
ˈheɪ.zəl	hazel
dɪm	dim
dɪˈstɜː.bəns	disturbance
ˈdraɪvə(r)	driver
ˈfleɪvə(r)	flavour
ˈtaɪdi	tidy
ˈtʃæn.səl.ɚ	chancellor
əˈɡen	again
ˈpetrəl	petrol
delt	dealt
dʒuˈlaɪ	July
ˈmɜː.mər	murmur
kənˈvɜːrt	convert
kənˈveɪ	convey
ðɪs	this
kaʊ	cow
bɪˈfɔː.hænd	beforehand
ˈkɔːr.ɪ.dɚ	corridor
pep	pep
ˈpær.ɪʃ	parish
ɔːf	off
rɪˈdʒek.ʃən	rejection
ˈlɒri	lorry
əkˈses.ə.bl̩	accessible
məˈʃiːnəri	machinery
ˈlɪt̬.ɚ	litter
ˈsæl.vɪdʒ	salvage
priːˈdestɪn	predestine
ɡʌn	gun
dɪˈfɪʃ.ən.si	deficiency
tɑːŋz	tongs
ˈlev.i	levy
ˌæb.nɔːˈmæl.ə.ti	abnormality
sɔːd	sword
ˈjuːnɪt	unit
pet	pet
ˈɪn.fən.tri	infantry
ˈkrɪp.l̩	cripple
ˈpɑːtnə(r)	partner
bɑː(r)	bar
ˈveriəs	various
ˈlɪz.əd	lizard
ˈdʒɒɡ.ɪŋ	jogging
lɔː	law
ˈsɪti	city
ˈdjuːti	duty
dɪˈprest	depressed
ˈkɑː.lɚ	collar,caller
mɔːrˈoʊvər	moreover
ˈfɒs.əl	fossil
daɪ	die,dye
θɔːt	thought
ˈvɝː.sə.t̬əl	versatile
ˈwɝːk.ʃɑːp	workshop
ˈæŋkl	ankle
ˈaʊtər	outer
ˈfɔːməli	formerly
ˈfəʊl.dər	folder
kloʊz	close
ˈsekənderi	secondary
θɪəˈret.ɪ.kəl	theoretical
ɪmˈbærəsmənt	embarrassment
ˈdɒlə(r)	dollar
ˈpɒt.ər.i	pottery
əˈɡreʃ.ən	aggression
ˈskæl.i.ən	scallion
mɑːp	mop
ˈpɪt.i.fəl	pitiful
ˈhəʊm.sɪk	homesick
ˈaɪərn	iron
ˈhek.tɪk	hectic
ˈpæt.ər	patter
fəˈtɒɡrəfə(r)	photographer
ˈkɒk.teɪl	cocktail
ˈmæd.mən	madman
seɪm	same
ˈɪd.i.əm	idiom
ˈpɑː.sli	parsley
ɪnˈrɪtʃ	enrich
prɑːkˈsɪm.ə.t̬i	proximity
ˈkʌn.dʒər	conjure
ˈɪnstɪtjuːt	institute
ˈθaʊznd	thousand
ˈprɒpəti	property
ˈkɑːntɪnənt	continent
ˈsɜːtnli	certainly
ˈtræfɪk	traffic
ədˈvaɪz	advise
hɝːl	hurl
ˌrev.əˈleɪ.ʃən	revelation
hʌɡ	hug
ɪˈlekʃn	election
ˈkɑːdbɔːd	cardboard
ˈkɑː.lɪˌflaʊr	cauliflower
ˈpær.ə.bl̩	parable
pɑːp	pop
dɪˈspeər	despair
ˈtres.pəs	trespass
ˈkaɪndli	kindly
hjuːˈmæn.ə.ti	humanity
ˌaʊtˈɡəʊ.ɪŋ	outgoing
ˈsɪn.ɪ.kəl	cynical
pɑːt	part,pot
ˈsʌndeɪ	Sunday
ˈsæləd	salad
kriˈeɪ.ʃən	creation
ɪˌlekˈtrɑːnɪk	electronic
ˈeɪ.li.ə.neɪt	alienate
bəˈləʊ.ni	baloney
ˈbjuːtɪfl	beautiful
ʤʌkstəpəˈzɪʃn	juxtaposition
ɪmˈplæk.ə.bl̩	implacable
ˈmedsn	medicine
leɪd	laid
ˈræʃ.ən.əl	rational
ˈkʌm.fi	comfy
rætɪfɪˈkeɪʃn	ratification
ˈkɒntækt	contact
ˈdʒenrəl	general
ʃɑːk	shock,shark
ˈkɒŋɡres	congress
ɪˈtɜː.nəl	eternal
əˈdɪk.tɪd	addicted
ˈles.ər	lesser
bɔːn	born
ˈeɪ.mi.ə.bl̩	amiable
elk	elk
prəʊb	probe
pleɪ	play
wɪəd	weird
dɪˈvaɪs	device
sepˈtembə(r)	September
ˈmær.əʊ	marrow
tempt	tempt
siː	see,sea
klæn	clan
əˈvaʊ	avow
ˈhed.laɪn	headline
ˈrekən	reckon,reckon
ɔːt	ought
wɪm	whim
ˈel.ə.kwənt	eloquent
ˈdjuː.bi.əs	dubious
ɪnˈvʌl.nər.ə.bl̩	invulnerable
ˈɑːkjupaɪ	occupy
ˈsɜːkəmstəns	circumstance
ˈvɜː.dʒɪn	virgin
ˈdəʊ.nər	donor
ˈseɪlə(r)	sailor
ˈfɪt.nəs	fitness
ɡroʊn	groan
fləʊn	flown
kɒst	cost
bleɪz	blaze
ˈmembərʃɪp	membership
taɪd	tide
ˈkrɪt.ɪk	critic
ɡloʊ	glow
ˈstuːdnt	student
ˈtɔːr.tʃɚ	torture
ˈplætfɔːm	platform
ˈɒk.sɪ.dʒən	oxygen
ˈtwɪt̬.ɚ	twitter
ˈkaʊnt.daʊn	countdown
ˈmeɪl.mæn	mailman
əv	of
ədˈvɑːns.mənt	advancement
ˈklev.ə.nəs	cleverness
kiːl	keel
ˈmʌðər	mother
ʃeə(r)	share
ˈfɒnd.nəs	fondness
hɪə(r)	here
ˌdaʊnˈsteəz	downstairs
vɒlt	vault
ˈkɒr.ɪ.dɔːr	corridor
ˈklɑː.si	classy
kənˈsɪdərəbli	considerably
ˈdʒɒɡ.l̩	joggle
ˈnɔːrðərn	northern
dəʊp	dope
ˈlev.ɚ	lever
ˈbʌk.l̩	buckle,buckle
ˈsen.tɪ.mənt	sentiment
pɑːˈster.ə.t̬i	posterity
ˌʌnɪkˈspektɪd	unexpected
ɪˈkweɪ.ʒən	equation
ˈvɪs.tə	vista
sɜːr	sir
daɪˈvɜː.ʃən	diversion
ˈkɔː.rəs	chorus
snoʊ	snow
ˌʌn.prəˈfeʃ.ən.əl	unprofessional
ˈem.pər.ər	emperor
wæk	whack
kæpˈtɪv.ɪ.ti	captivity
ɪnˈhæb.ɪt	inhabit
ɪnˈkɒm.pɪ.təns	incompetence
ˈren.ə.sɑːns	renaissance
ˈpɪriəd	period
ˈhɪd.ən	hidden
ˈplɔː.zə.bl̩	plausible
əˈsɪst	assist
ˈfɑrˌsɑɪ·t̬ɪd	farsighted
ˌædməˈreɪʃn	admiration
ʃɜːrt	shirt
ˈprɑːbləm	problem
nʌt	nut
ˈprɑːdʌkt	product
ˈklɪə.rəns	clearance
ˈprəʊ.naʊn	pronoun
ɑːr	our,are
ɒmˈnɪp.ə.tənt	omnipotent
ˈkʌl.ɪ.nər.i	culinary
mʌtʃ	much
ˈɔːlweɪz	always
fərˈevə(r)	forever
elf	herself,elf
sɪˈkjʊərəti	security
ɪnˈseɪn	insane
ˈtʃænl	channel
ˈeniθɪŋ	anything
ˈtʃɪə.rɪŋ	cheering
ɪnˈvɪz.ɪdʒ	envisage
ˈlɑː.stɪŋ	lasting
ˈspeɪs.ʃɪp	spaceship
ˌluːkˈwɔːm	lukewarm
əˈsper.ɪ.ti	asperity
əkˈnɑːlɪdʒ	acknowledge
ˈmɔːrəl	moral
dɪˈraɪv	derive
ˈfɒləʊ	follow
ˈsentə(r)	centre
ˈkændi	candy
mjuˈziːəm	museum
fraɪz	fries
ˌʌn.dəˈstæn.də.bl̩	understandable
ˌɪn.kənˈviː.ni.əns	inconvenience
ˈwɜːrʃɪp	worship
ænt	aunt,ant
ˈrɪb.ən	ribbon
ˈsuː.pə.vaɪz	supervise
dɪsˈfʌŋk.ʃən.əl	dysfunctional
sɪˈlek.tɪv	selective
læst	last
ˈɔːtəm	autumn
ʃeɪv	shave
ˈdʒæk.pɒt	jackpot
wɒnt	want
ɜːθ	earth
dɪˈstɜːrbɪŋ	disturbing
ˈhev.i.nəs	heaviness
præŋk	prank
ɡʌst	gust
ˈkɑː.tən	carton
əˈdɔːnmənt	adornment
ˈhjuːmən	human
ˌruː.dɪˈmen.tər.i	rudimentary
spent	spent
səˈpɔːrt	support
naʊn	noun
tʃɔɪs	choice
ˈefərt	effort
dɪˈfaɪ	defy
ˈpɑːsəbl	possible
ˈdʒʊr.i	jury
ˈwɪr.i	weary
ˈʃæɡ.rɪn	chagrin
ˈfɜːst.li	firstly
ˈklaɪmɪŋ	climbing
kjʊr	cure
əbˈsɔːb	absorb
kəˈsiː.nəʊ	casino
ˈʌltɪmətli	ultimately
rɪˈzɪstəns	resistance
ʌnˈtruː	untrue
ʃɔːrt	short
ˈden.sɪ.ti	density
ˈloʊkeɪtɪd	located
mʌʃ	mush
ˈʃeɪ.di	shady
pɝːtʃ	perch
əˈpend	append
ˈpleʒər	pleasure
ˈfaɪnæns	finance
ˈɒpəreɪt	operate
ˈfæktər	factor
ˈlaɪ.kɪŋ	liking
sfɪər	sphere
ˌəʊ.vəˈwelm	overwhelm
ˌkɒn.stɪˈtjuː.ʃən	constitution
rɒŋ	wrong
ˌmel.ə.drəˈmæt.ɪk	melodramatic
æsk	ask
səbˈdʒek.tɪv	subjective
brʌntʃ	brunch
ˈpiːpl	people
ˈtelɪfəʊn	telephone
ˌæm.jʊˈnɪʃ.ən	ammunition
ˈmaɪ.krə.fəʊn	microphone
ˈkriː.meɪt	cremate
ɪnˈdɔːs	endorse
ɪmˈpen.dɪŋ	impending
fɪl	fill
sɑːlv	solve
prəˈnaʊns	pronounce
ˌɪndɪˈpendənt	independent
ˈbetɪŋ	betting
ˈpaɪ.rət	pirate
ɪnˈten.sɪv	intensive
ɪkˈskluː.ʒən	exclusion
ɪˈspeʃəli	especially
ˈfɔːrml	formal
ˈeθ.ɪk	ethic
ˌdɪs.kəˈnekt	disconnect
ˈmæn.ɪ.kjʊər	manicure
swer	swear
kɜːrv	curve
kənˈtentmənt	contentment
ˈsɪlvər	silver
əˈveɪləbl	available
ˈprem.i.eər	premiere
ˌləʊ.kəˈməʊ.tɪv	locomotive
dɔː(r)	door
krest	crest
ˈflʌr.ɪʃ	flourish
klɔːθ	cloth
ˈtes.tɪ.mən.i	testimony
ˈpen.dɪŋ	pending
ˈjuːsləs	useless
dʒuːs	juice
ˈkɒnfərəns	conference
vaʊ	vow
ˈstɝː.ɪŋ	stirring
spriː	spree
ˈænɪml	animal
ˈbrəʊ.kər	broker
hɒt	hot
ˈbroʊ.kɚ	broker
əˈnæl.ə.dʒi	analogy
ˈflæt.li	flatly
ˈnæv.ɪ.ɡeɪt	navigate
prɪˈdɪkt	predict
mæl	mall
ˈɡræf.ɪks	graphics
dʌŋk	dunk
keɪm	came
praʊd	proud
ˌelsˈwer	elsewhere
ˈpəʊ.stər	poster
rɪˈflekt	reflect
ˈsem.i	semi
kəmˈpel	compel
ˈsəʊldʒə(r)	soldier
ˈsentrəl	central
ʌnˈfɔːtʃənətli	unfortunately
ɪnˈfest	infest
ˈɡruː.əl	gruel
ˈhaɪli	highly
ˌvaɪəˈlɪn	violin
ˈbiː.pər	beeper
trɒl	troll
θɚˈmɑː.mə.t̬ɚ	thermometer
ˈʃaʊə(r)	shower
ˈwɜːθ.ləs	worthless
rɪˈstrɪktɪd	restricted
ˈmɪs.tɪk	mystic
ˈeniwer	anywhere
ɜːdʒ	urge
dɪˈtɜːr	deter
krəʊ	crow
fəˈɡet.fəl	forgetful
bænd	band
haʊˈevər	however
ˌʌndərˈniːθ	underneath
ˌpʌblɪˈkeɪʃn	publication
ˌrekəˈmend	recommend
ʌp	up
ɪnˈfleɪ.ʃən	inflation
sled	sled
wɒtˈevə(r)	whatever
ˈfɜː.nɪʃ	furnish
kənˈdʒʌŋk.ʃən	conjunction
ˈmeʒə(r)	measure
ˌθiː.əˈlɒdʒ.ɪ.kəl	theological
ˌɒl.təˈreɪ.ʃən	alteration
ˈfrʌn.tɪdʒ	frontage
ˌprɒp.əˈzɪʃ.ən	proposition
dɪˈsiːst	deceased
ˌrez.ɪɡˈneɪ.ʃən	resignation
ˈet̬.ɪ.kət	etiquette
bɑːɡ	bog
ˈɑː.pə.reɪ.t̬ɚ	operator
ˈkræk.ər	cracker
ˈmaɪ.ɡrənt	migrant
koʊt	coat
ˈmæm.əl	mammal
pəˈpetʃ.u.əl	perpetual
ˈskæl.pəl	scalpel
rɪˈpruːv	reprove
fɔːrs	force
dɒɡ	dog
ˈmæɡəziːn	magazine
kənˈfrʌnt	confront
dɪˈspens	dispense
ˈbel.əʊ	bellow
ðəʊz	those
kaʊtʃ	couch
dʒeɪd	jade
ˈendʒɪn	engine
stɑːk	stock,stalk,stark
prɪˈsaɪs	precise
kəmˈpæn.jən	companion
ˈbɑː.tər	barter
ˈen.tə.praɪz	enterprise
ekˈses.ɪv	excessive
əˈlaʊ	allow
əˈfekʃn	affection
ˈæs.et	asset
ˌdɪsəˈpruːvl	disapproval
ˈfʌn.əl	funnel
ˈfæs.aɪl	facile
flæmˈbɔɪ.ənt	flamboyant
boʊn	bone
ɪz	is
ˈtel.ɪ.ɡrɑːf	telegraph
flɑːɡ	flog
ɪnˈæk.ʃən	inaction
diːp	deep
əˈtæk	attack
luːs	loose
ˈen.i.haʊ	anyhow
ˈlʌl.ə.baɪ	lullaby
riːˈɔː.ɡən.aɪz	reorganize
ˈklem.ən.si	clemency
ˈmjuːzɪk	music
ˈhezɪteɪt	hesitate
ˌɪnstɪˈtjuːʃn	institution
kæf	calf
ˈbaʊn.ti	bounty
ˈtʌtʃ.i	touchy
ˈɪm.ɪ.nənt	imminent
lɜːrn	learn
ˈbɑː.bɪ.kjuː	barbecue
ˈriː.fɪl	refill
deɪm	dame
ˈɒp.tɪ.kəl	optical
ˈkɑːk.roʊtʃ	cockroach
ˈswɪn.dəl	swindle
skɪl	skill
peə(r)	pair
ˈserəmoʊni	ceremony
rɪˈzaɪn	resign
dent	dent
ˌdiː.viˈeɪ.ʃən	deviate
ˈplænɪŋ	planning
ˌməʊ.tɪˈveɪ.ʃən	motivation
wɔːrp	warp
ɪmˈbɒd.i	embody
ˈfɔːml	formal
hʌŋ	hung
ˌrepjuˈteɪʃn	reputation
ˈhaɪ.kɪŋ	hiking
fɔːrˈstɑːl	forestall
tɔːk	talk
klɑːk	clock,clerk
tuːl	tool
ɡlæns	glance
eər	heir,err
ˈsɔː.sər	saucer
ˈbɔɪ.kɒt	boycott
ækˈsiːd	accede
ˈæp.l̩	apple
ˈnaɪnti	ninety
ˈrɔɪəl	royal
ˈɑːrtɪst	artist
ˈviːəkl	vehicle
kənˈtɪn.ju.əl	continual
ˈlæt.ɪs	lattice
spɪr	spear
hʊk	hook
ˈfriːkwənt	frequent
liːf	leaf
fɔːrt	fort
ˈtæksˌpeɪ.ər	taxpayer
ˈeksələnt	excellent
ˈæm.ə.rəs	amorous
sərˈpraɪz	surprise
tɔɪ	toy
ˈdʒɪn.dʒər	ginger
əˈpɔː.lɪŋ	appalling
ˈsem.bləns	semblance
ˈɑːftə(r)	after
pɜːl	pearl
dɪˈzɒlv	dissolve
əˈkɔː.dəns	accordance
ˈkæp.tɪ.veɪt	captivate
ˈkeɪbl	cable
lɔːntʃ	launch
ɪkˈsploʊʒn	explosion
wæks	wax
ˈtʊə.nə.mənt	tournament
ˈwɪl.də.nəs	wilderness
ˈnʌt.i	nutty
ˈfem.ɪ.nɪst	feminist
ˈʌðəwaɪz	otherwise
ˈhɔːn.tɪŋ	haunting
ˈɔːrɪənt	orient
meɪl	mail,male
skriːtʃ	screech
ˈɔːltər	alter
ɪˈnæk.jʊ.rət	inaccurate
ˈtrʌstˌwɜː.ði	trustworthy
hiːd	heed
lɑːt	lot
kəmˈpæt.ɪ.bl̩	compatible
mɜːdʒ	merge
ˈtɪm.ɪd	timid
fluːt	flute
ˈfɔːrkæst	forecast
əˈkeɪʒnəli	occasionally
fæt	fat
bɜːd	bird
stəʊn	stone
ˈwɪz.dəm	wisdom
bɑːdʒ	barge
ˈtoʊ.stɚ	toaster
ˌəʊ.və.prəˈtek.tɪv	overprotective
fɑːst	fast
ˈrev.ər.əns	reverence
sens	sense
ˈlaɪ.tən	lighten
ˈmærid	married
ˈɔː.rəl	oral
ɪnˈdʒʌs.tɪs	injustice
ˈpɒm.ɪˌɡræn.ɪt	pomegranate
sɪns	since
ˈdæɡ.ər	dagger
ɔːɡˈment	augment
den	den
ɪnˈfɜːr	infer
smɪθ	smith
brɔːd	broad
həˈləʊ	hello
ˈeniweə(r)	anywhere
klɑːs	class
ˈʌŋkl	uncle
əˈfeə(r)	affair
ˈwɔːr.droʊb	wardrobe
ˌkɒm.plɪˈkeɪ.ʃən	complication
fəˈɡeɪv	forgave
ˈɪntə	into
ɪˈluː.mɪ.neɪt	illuminate
snʌɡ	snug
əˈbreɪ.sɪv	abrasive
feɪk	fake
rɪˈliːs	release
ˈθɜːrzdeɪ	Thursday
ˈnjuːkliə(r)	nuclear
tʌn	ton
ɪnˌtɜːrprɪˈteɪʃn	interpretation
boʊt	boat
ˈklaʊd.ləs	cloudless
skɔːld	scald
kəmˈpraɪz	comprise
əˈlæk.rə.ti	alacrity
pəˈremp.tər.i	peremptory
ˈfɔːtʃuːn	fortune
ˈlɪt.ər	litter
ˈmaɪld.li	mildly
ˈflæt.ər.i	flattery
læʃ	lash
ˈpɒr.ɪdʒ	porridge
sɪˈlekt	select
ˈkɑːnsərt	concert
ˈres.ɪ.pi	recipe
rend	rend
ˈɒb.stɪ.nət	obstinate
ˈdʒɜːrni	journey
ˈwɪntər	winter
dɪˈzaɪər	desire
taɪˈtæn.ɪk	titanic
tʃuːz	choose
ˈæktrəs	actress
ˈɔː.tə.ɡrɑːf	autograph
ˈsɪŋər	singer
ˈmiːdiə	media
rɪˈkʌvər	recover
kəˈmɪtmənt	commitment
ˈnəʊ.tɪ.faɪ	notify
ˈræf.l̩	raffle
prɪˈkeə.ri.əs	precarious
ˈdəʊ.kər	joker
praɪˈɔːrəti	priority
əˈɡɑːst	aghast
əˈbɔː.tɪv	abortive
ˈæʃ.treɪ	ashtray
ʃəl	shall
kæt	cat
ˈræn.dəm	random
ˈseɪfli	safely
ədˈvænst	advanced
θeft	theft
ˈmɪdl	middle
kəʊˈhæb.ɪt	cohabit
ˈdʒɒb.ləs	jobless
prəˈpraɪə.tər	proprietor
tʃɜːtʃ	church
ˈluː.zər	loser
ˈʌpə(r)	upper
ˈkɒndʌkt	conduct
kjuːb	cube
θɪŋ	thing
ˈʌðərwaɪz	otherwise
ɑːt	art,ought
ˈraɪtɪŋ	writing
ˈwebsaɪt	website
ækˈtɪvəti	activity
kəˌmjuːnɪˈkeɪʃn	communication
ˈreɪ.ni	rainy
breɪn	brain
ɪnˈvælɪd	invalid
bəˈlɪs.tɪk	ballistic
ˈmiːtə(r)	metre,meter
həʊz	hose
kɜːrb	curb
θiːv	thieve
kəʊˈɒp.ər.ə.tɪv	cooperative
ˈres.paɪt	respite
ˈkiː.həʊl	keyhole
ˌjuːnɪˈvɜːrsəti	university
ˌrep.rɪˈhen.sə.bl̩	reprehensible
ɪɡˈzɪbɪt	exhibit
bɪˈhəʊld	behold
liːʃ	leash
ˈblɪs.tər	blister
ˈdʒɜː.mɪ.neɪt	germinate
ɪˈkɒnəmi	economy
ˈsɜː.tʃɪŋ	searching
ɪnˈtruː.dər	intruder
ˈfrʌn.tɪər	frontier
ˈbrɪliənt	brilliant
kræb	crab
ˈbʌŋ.kər	bunker
ˈhelpfl	helpful
pʌntʃ	punch
ˈkɒl.ə.ni	colony
ˈkɑːn.træk.tɚ	contractor
pəˈteɪtoʊ	potato
spɔːn	spawn
pəˈfʌŋk.tər.i	perfunctory
triːt	treat
tempˈteɪ.ʃən	temptation
ˈriː.leɪ	relay
ˈbeɪ.ɡəl	bagel
ˌmɪsˈɡaɪ.dɪd	misguided
ˈfæn.təm	phantom
flɔːr	floor
ˌæɡ.rəˈveɪ.ʃən	aggravation
ˈprezns	presence
ˈaʊtdɔː(r)	outdoor
ɪkˈstɪŋkt	extinct
ˈlæf.tɚ	laughter
ˈluː.brɪ.kənt	lubricant
ɪkˈspekt	expect
ˈprɒd.ɪ.ɡəl	prodigal
əˈkred.ɪ.tɪd	accredited
rent	rent
ˈbʌtər	butter
ˈbɪt.ən	bitten
rɪˈzaʊnd	resound
tɔːt	taught
ˈsɪmpl	simple
bæɡ	bag
ˈfæʃn	fashion
dɒl	doll
ˈwiːknəs	weakness
ˈwɝːld.waɪd	worldwide
ˈstjuːpɪd	stupid
ˈfɔːr.əm	forum
ɪɡˈzɪstəns	existence
ˈnaʊ.ə.deɪz	nowadays
ˈpɒz.ə.tɪv.li	positively
bləʊk	bloke
sərˈtɪfɪkət	certificate
ˈdɑːknɪs	darkness
ˈdeɪli	daily
ˈpɑːlətɪks	politics
ˈkɔ·fiˌhɑʊs	coffeehouse
wɔːrmθ	warmth
ʌnˈdʒʌst	unjust
noʊ	no,know
swɑːt	swat
ɪkˈspens	expense
taɪts	tights
ˌmɪsˈtrʌst	mistrust
ˈkrɑːs.roʊd	crossroad
ˈɔː.dɪ.bl̩	audible
ˈsɜː.vɪŋ	serving
ˈrʌʃn	Russian
ˈær.ə.ɡənt	arrogant
ˌtrænspɔːˈteɪʃn	transportation
kəˈmænd	command
ˈpɑːs.tʃər	pasture
ˈdɒɡ.i	doggy
ˈbəʊst.fəl	boastful
fɔːrθ	fourth,forth
praɪˈmiː.vəl	primeval
pəˈtenʃl	potential
ˈbɒd.i.ɡɑːd	bodyguard
ˈeθ.ɪ.kəl	ethical
prɪˈkɔː.ʃən	precaution
ˈlænd.fɔːl	landfall
stəʊl	stole
ˈtiːtʃə(r)	teacher
baɪk	bike
preɪz	praise
sɪp	sip
ˈməʊbaɪl	mobile
ˈhæŋˌəʊ.vər	hangover
ˈrɪðəm	rhythm
kætʃ	catch
hjuː	hew,hue
ˌendʒɪˈnɪə(r)	engineer
ˈɡɑː.mənt	garment
ˈdiː.poʊ	depot
fɪʃ	fish
step	step,steppe
ɡriːk	Greek
ɪkˈsiːd	exceed
ˈdʒentli	gently
stuːp	stoop
ˈmɑː.nə.ster.i	monastery
ˈeni	any
ˈpɑː.dən	pardon
dʌmp	dump
priːst	priest
pɒnd	pond
ˈdʒenərəs	generous
wʊf	woof
dɪˈsɪʒn	decision
stræp	strap
ˈedʒ.i	edgy
ˈpet.i	petty
ˈaʊt.kʌm	outcome
ˈælaɪ	ally
ˈbɪl.jɚdz	billiards
ˈsɜː.kɪt	circuit
roʊɡ	rogue
dɪˈbeɪt	debate
səkˈses	success
ˈsɪəriːz	series
ˈævərɪdʒ	average
ˈfɜː.nɪs	furnace
kjuːt	cute
ˌmænjuˈfæktʃə(r)	manufacture
ˈstɪm.jʊ.leɪt	stimulate
dʒɔː	jaw
pɔːn	pawn
dɪsˈhɑː.tən	dishearten
dɪˈsmeɪ	dismay
ˈrekərd	record
ˈsəʊʃl	social
ɪnˈtɜːn	intern
ˈmembəʃɪp	membership
vəˈreɪ.ʃəs	voracious
ˈeɪ.bli	ably
muːn	moon
ˈkɑː.tər	carter
dɒdʒ	dodge
ˈkɒm.pɪ.tənt	competent
stres	stress
tuːb	tube
ˌsaɪənˈtɪfɪk	scientific
ˈpæl.ət	palate,palette
dɪˈsaɪd	decide
ster	stare,stair
ˈɡɑː.dən.ər	gardener
brɪm	brim
ˈlæt̬.ɚ.əl	lateral
ɪmˈplɔːr	implore
dɪˈpliːt	deplete
wɔːr	war,wore
ɡæɡ	gag
ˈleɪə(r)	layer
kroʊ	crow
ˈseɪfti	safety
ˈɡet.əʊ	ghetto
ˈɡlɪt̬.ɚ	glitter
ˈskel.ɪ.tən	skeleton
fɑːt	fought,fart
ˌsɪksˈtiːn	sixteen
waɪp	wipe
fɔːk	fork
ˈroʊ.bɑːt	robot
ɪˈluː.ʒən	illusion
bloʊ	blow
ˈkɑːnsntreɪt	concentrate
dɪˈkeɪ	decay
ˈkɒntest	contest
fəˈbɪd.ən	forbidden
ˈdraʊ.zi	drowsy
klɪntʃ	clinch
swɪtʃ	switch
slɪm	slim
ˈtrɔː.mə	trauma
ˈkaʊn.səl.ɪŋ	counselling
hɜːd	herd
iːl	eel
ˈdiː.mən	demon
ˌaʊtˈspəʊ.kən	outspoken
ˈpɒp.i	poppy
kɑːrd	card
ˈhɑːmfl	harmful
ˈʃaɪni	shiny
piːtʃ	peach
dɪˈlɪŋ.kwənt	delinquent
ˈstʌb.əl	stubble
ˈkætʃ.i	catchy
ˈbʊtʃ.ər	butcher
ˈdres.ɪŋ	dressing
jəʊk	yolk,yoke
ɪmˈbjuː	imbue
ʃer	share
ˌriːəˈlɪstɪk	realistic
ˈkɑːnstənt	constant
juˈnaɪt	unite
sɪˈrɪndʒ	syringe
ˈplæt.nəm	platinum
ˈrʌɡ.bi	rugby
ˈdʒɒl.i	jolly
ˈɔːɡən	organ
ˈhaʊs.meɪd	housemaid
ɪnˈdjʊər	endure
ˈfoʊtəɡræf	photograph
ɡrəʊn	groan
ˈrʌnər	runner
prəˈfeʃənl	professional
ˈbræn.di	brandy
prəˈdjuːs	produce
ɡriːt	greet
ˈæspekt	aspect
bɪrd	beard
keɪs	case
əˈmjuːz.mənt	amusement
ˈfəʊ.li.ɪdʒ	foliage
ˈekstrækt	extract
ˈnuːzpeɪpər	newspaper
ˌɒk.jʊˈpeɪ.ʃən	occupation
ˈɡʊd.i	goody
ˈkɜːrəntli	currently
briːz	breeze
ˈɪn.bɔːrn	inborn
ˈnɔɪzi	noisy
ˈtaʊər	tower
pərˈtɪkjələrli	particularly
hjuːˈmɪl.i.eɪ.tɪd	humiliated
lʌst	lust
prɪˈpɒs.tər.əs	preposterous
ɪˈvæp.ər.eɪt	evaporate
peɪdʒ	page
ɪksˈtʃeɪndʒ	exchange
ˈfæs.ɪ.neɪ.tɪŋ	fascinating
ˈfjʊə.ri	fury
fluːk	fluke
mɪns	mince
ˈrɪvər	river
njuːd	nude
ˈdʒaɪənt	giant
lɑːk	lock,lark
fjuːm	fume
ˈdaʊn.raɪt	downright
mɪlk	milk
ˌrek.riˈeɪ.ʃən	recreation
ɪnˈhɪb.ɪt	inhibit
ˈpes.tər	pester
ˈɔː.dəl.i	orderly
hɔːs	horse,hoarse
dɪˈvɪʒn	division
ˈsəʊ.lər	solar
ɪˈvæl.ju.eɪt	evaluate
ˈventʃər	venture
ˈkɑː.blɚ	cobbler
hæŋ	hang
ɡəˈlænt	gallant
ˈdɜː.ti.nəs	dirtiness
æθˈlet.ɪk	athletic
ˈlɪt.ər.əl.i	literally
ˈnjuː.mə.rəs	numerous
kənˈfɔː.mɪ.ti	conformity
ˈkɑːndʌkt	conduct
ˈdɪr.ɪst	dearest
ˌsepəˈreɪʃn	separation
ˈnoʊbədi	nobody
ˈrɪd.əns	riddance
ˈspæt̬.ɚ	spatter
ˈmɒk.ɪŋ	mocking
fʌs	fuss
ʃaɪn	shine
prəˈtek.tɪv	protective
ˌdɪsˈsɪm.ɪ.lər	dissimilar
ˈhjuː.mɪd	humid
rest	rest,wrest
waɪld	wild
ɪnˈtenʃn	intention
ˈdaɪ.ə.lɒɡ	dialogue
ɡɜːrl	girl
ˈbjʊə.rəʊ	bureau
əˈdɒp.ʃən	adoption
ˈbjuːtɪfli	beautifully
snɔːr	snore
fɪɡ	fig
kəʊˈɒp.ər.eɪt	cooperate
ˈbriːfli	briefly
lɪmp	limp
ˌkɒm.prɪˈhen.sɪv	comprehensive
ˈrep.rɪ.mɑːnd	reprimand
ˈræn.sɪd	rancid
nɜːs	nurse
ˈtelɪfoʊn	telephone
ken	ken
ɪˈlekt	elect
swiːp	sweep
ˈfɑː.səl	fossil
draɪ	dry
ɪɡˈzɒlt	exalt
smɪər	smear
ˈedɪtər	editor
ˈnjuːli	newly
hʌŋk	hunk
ˈvɑː.nɪʃ	varnish
ˌkɔːr.ɪˈspɑːnd	correspond
mæɡˈnet.ɪk	magnetic
wɔːl	wall
ˈɪnəsnt	innocent
ˈmet.rɪk	metric
ˈlæt.rəl	lateral
spaɪər	spire
ˈɑːr.ɡɑːn	argon
kəʊˈhɪər	cohere
ˈaʊt.breɪk	outbreak
ˈtɔːrɪst	tourist
maʊs	mouse
ɪmˈpɔːrtns	importance
ˈvɒm.ɪt	vomit
kənˈvɪkt	convict
ɪmˈprɒp.ər	improper
fəˈmɪliə(r)	familiar
ˈɪntrəst	interest
ˈkʌmfət	comfort
ˈɪndɔː(r)	indoor
ˈəʊ.vəl.i	overly
ˈvaɪ.ə.bl̩	viable
ˈbæn.ɪʃ	banish
ˈʌndər	under
əˈpærənt	apparent
ˈɡɔːnt.lət	gauntlet
ˈpɪəriəd	period
ɪnˈkɜːrɪdʒ	encourage
ˈheð.ər	heather
kənˈtem	contemn
ˈfɜːrðər	further
ˈspær.əʊ	sparrow
pə(r)	per
skruː	screw
ˈskeə.ri	scary
ˈprɑːpərti	property
swɪm	swim
ˈbiː.ɪŋ	being
ˈɪntərvl	interval
fiːt	feet,feat
ˈædʌlt	adult
ˈkʌt.lə.ri	cutlery
ˈstɒk.ɪŋ	stocking
dɪˈspruːv	disprove
ˈɪd.i.ət	idiot
ˈtʃæptə(r)	chapter
kəˈmɪz.ə.reɪt	commiserate
kəˈrɪr	career
ˈdʒʊə.ri	jury
ˈɔː.rə	aura
ˈɑː.blɑːŋ	oblong
ˈriːəli	really
θrəʊt	throat
əbˈteɪn	obtain
ˈpɑːlɪʃ	polish
ɪnˈtes.tɪn	intestine
ˈreɪ.ʃəl	racial
ɒf	off
bæŋk	bank
kəʊld	cold
dəˈrekʃn	direction
rɪˈmɑːrk	remark
ʌnˈtaɪdi	untidy
həʊp	hope
kəʊt	coat
ˈprɪm.ɪ.tɪv	primitive
hɑːθ	hearth
ˈvæk.siːn	vaccine
prəˈseʃ.ən	procession
ˈkɑːmən	common
kɑːrp	carp
ˈlæs.tɪŋ	lasting
dɪˈsɪn.trə.stɪd	disinterested
ˌɪnəˈbɪləti	inability
mæst	mast
səbˈtrækt	subtract
ˌʌpˈsteəz	upstairs
ˈseɪlɪŋ	sailing
ˌmæθəˈmætɪks	mathematics
ænˈtɑːk.tɪk	antarctic
ˌbes.tiˈæl.ə.ti	bestiality
kənˈsiːl.mənt	concealment
ˈnɜːrvəs	nervous
ˈɡreɪtfl	grateful
praɪm	prime
ɡlɪtʃ	glitch
ˈmɔː.səl	morsel
ˈdaɪ.ə.tər.i	dietary
rɪˈspekt	respect
drɔː	draw
wɑːʃ	wash
prɪˈskrɪp.ʃən	prescription
ˌriːˈsaɪ.klɪŋ	recycling
ˈlɑː.ðər	lather
ˈhæm.pər	hamper
fækt	fact
ˈhedeɪk	headache
nəʊˈvembə(r)	November
məˈnuː.vər	manoeuvre
ber	bear,bare
ˈmer.i	merry
ɔɪl	oil
dəʊz	doze
tɔːn	torn
tʃæp	chap
ˈpoʊətri	poetry
məˈsɑːʒ	massage
stiːl	steal,steel
ɪnˈʧɑːntmənt	enchantment
ˈbeɪs.ləs	baseless
dʒiˈɑːɡrəfi	geography
ˌɑːtʃˈbɪʃ.əp	archbishop
ˈɔːr.əl	oral
kənˈsent	consent
dɪˈpen.də.bl̩	dependable
ˈkʌn.stə.bl̩	constable
pʌf	puff
əbˈses.ɪv	obsessive
ˈrɪp.l̩	ripple
əˈbliːk	oblique
dɪsk	disk,disc
ˈækʃn	action
ˈtrædʒ.ə.di	tragedy
hɑːk	hawk
maɪ	my
ɪnˈsæn.ə.ti	insanity
ˈspeʃ.əl.ti	specialty
wɜːl	whirl
wɜːd	word
ədˈvɑːntɪdʒ	advantage
ˈfeɪvə(r)	favour
rɪˈtaɪəmənt	retirement
ˈhɔːr.moʊn	hormone
frəʊz	froze
ˈtræn.skrɪpt	transcript
ˈselɪbreɪt	celebrate
wɔːm	warm
ˈvaɪtl	vital
bleɪd	blade
ˈɔː.təʊ	auto
ˈbɒt.l̩d	bottled
ɪnˈvɒlv	involve
ˈsʌp.l̩	supple
əˈbrɪdʒ	abridge
ˈdʒʌŋ.ki	junkie
pərˈtɪkjələr	particular
ˈlektʃər	lecture
ˈdeɪ.taɪm	daytime
ˈhɑːrmfl	harmful
plæt	plait
rɔːŋ	wrong
nɔːθ	north
welθ	wealth
dɪˈstres	distress
ˈdɔː.step	doorstep
mɑːt	mart
huːt	hoot
kənˈsɜːn	concern
bɑːnd	bond
ˈɔː.kɪ.strə	orchestra
dɪˈteɪn	detain
kənˈtroʊl	control
dɪˈstrʌk.tɪv	destructive
ˈmoʊbl	mobile
ˌprɑː.bəˈbɪl.ə.t̬i	probability
skɪd	skid
ˈdɒl.fɪn	dolphin
ˈrɑːz.bər.i	raspberry
ˈevribɑːdi	everybody
riˈæləti	reality
dɪˈzɑːstə(r)	disaster
ɑːpt	opt
daɪər	dire
fərˈɡet	forget
ˈpaɪ.ə.ti	piety
məˈtjʊər	mature
pek	peck
ˈmæn.jʊ.skrɪpt	manuscript
paʊt	pout
ɡɒd	God
sɪˈleb.rɪ.ti	celebrity
ˌiː.kəˈnɒm.ɪ.kəl	economical
ˈtʃæt.ər	chatter
əˈplen.ti	aplenty
ˈlɔːri	lorry
ˈvɪzɪtə(r)	visitor
dɪˈstɜːb	disturb
ˈlɪmɪtɪd	limited
ˈsetl	settle
siːk	seek
sniːk	sneak
mjuˈzɪʃn	musician
ˈæksent	accent
ɪnˈlɑːdʒ.mənt	enlargement
kəmˈplaɪ.əns	compliance
ˈaʊt.let	outlet
ˈstɔːri	story
sɪˈvɪl.i.ən	civilian
ˈelɪveɪtə(r)	elevator
ˌwiːkˈend	weekend
səˈkjʊrəti	security
ˈpeɪpə(r)	paper
laʊd	loud
ˈɑːmi	army
ˈleðə(r)	leather
ˈprɒs.tɪ.tjuːt	prostitute
ˈjʊr.ɪn	urine
ˈpreznt	present
ɪˈlæb.ər.ət	elaborate
wɒd	wad
ˈblæk.meɪl	blackmail
tʃɑːrt	chart
hɪˈstɔː.ri.ən	historian
ˈprɪntə(r)	printer
ˈfɒs.tər	foster
ˈiː.zəl	easel
ˈfliː.tɪŋ	fleeting
ˈækses	access
ˈsmoʊkɪŋ	smoking
həʊst	host
ɪnˈsʌltɪŋ	insulting
rɪˈzɔː.sfəl	resourceful
rʌsl̩	rustle
ˈsʌŋ.kən	sunken
ˈbæs.kɪt	basket
ˈlʌvli	lovely
ˈkrɪmɪnl	criminal
ˈɪn.stɪŋkt	instinct
əˈdʒɜːn	adjourn
ˈɔː.fən	orphan
kləʊk	cloak
hɜːrt	hurt
prɪˈsaɪsli	precisely
pɚˈsen.t̬ɪdʒ	percentage
ˈpez.ənt	peasant
ˈæb.də.mən	abdomen
ˌʌnˈeθ.ɪ.kəl	unethical
klɒt	clot
ˈsɜː.kəm.skraɪb	circumscribe
nest	nest
ˈeɪ.prən	apron
ˈɑːt.fəl	artful
vekˈseɪ.ʃən	vexation
fɒnd	fond
ˈpɑːti	party
pʌŋk	punk
ˈfæs.ɪt	facet
ˈveɪ.kənt	vacant
ˈkɑːr.ɡoʊ	cargo
ˈkɑːn.dəm	condom
ˈdɪdʒ.ɪ.təl	digital
fər	for
dɪsˈɡʌstɪd	disgusted
bʌmp	bump
ˈdɪfɪkəlti	difficulty
ˈdʒep.ə.di	jeopardy
fɪrs	fierce
ˈdɒdʒ.i	dodgy
ˈsɜːvənt	servant
ˈrefjuːs	refuse,refuse
ˌdɪstrɪˈbjuːʃn	distribution
dres	dress
ˈoʊnli	only
ɪnˌvestɪˈɡeɪʃn	investigation
fəʊk	folk
ˈænjuəl	annual
ˈmɪnərəl	mineral
pəˈrɪm.ɪ.tər	perimeter
hætʃ	hatch
ʃi	she
dɪˈvaʊt	devout
ˈspeʃ.əl.aɪz	specialize
ɪnˈfɔːsmənt	enforcement
ˈprɒm.ɪ.nənt	prominent
ʌnˈkʌmftəbl	uncomfortable
ˈpʌmp.kɪn	pumpkin
rɪˈspektɪvli	respectively
ˈsʌk.ʃən	suction
ˈdəʊ.sɪdʒ	dosage
ˈbreɪ.zən	brazen
klaʊt	clout
skweə(r)	square
ˈpæsɪdʒ	passage
ˈren.təl	rental
daʊt	doubt
ˈrəʊ.zi	rosy
ɪˈnæd.ɪ.kwə.si	inadequacy
pəˈsɪf.ɪk	pacific
bʊˈkeɪ	bouquet
əˈkweɪnt	acquaint
ˈsɑːv.rən	sovereign
ˈpek.tər.əl	pectoral
ˈwepən	weapon
ˈdeɪ.zi	daisy
ɔːb	orb
əbˈzɜːv	observe
ˈnesəsəri	necessary
ˈreskjuː	rescue
snæp	snap
ˈæd.mɪ.rəl	admiral
ˈdɪt̬.oʊ	ditto
wi	we
ˈnaɪ.tɪŋ.ɡeɪl	nightingale
ˈɒp.rə	opera
mɑːsk	mosque,mask
fæks	fax
skæn	scan
strəˈtiː.dʒɪk	strategic,strategic
ˈdaʊ.ri	dowry
ˈkɒntrækt	contract
skælp	scalp
ˈleɪ.aʊt	layout
bɝːθ	berth,berth
ˈket.l̩	kettle
ˈrɪs.ki	risky
ˈder.i	dairy
ˈmʌs.tæʃ	moustache
ˈmɒn.ə.ki	monarchy
ˈedʒukeɪtɪd	educated
wɒn	wan
ˈmoʊstli	mostly
temp	temp
ˈstɑː.lɪŋ	starling
ʌnˈhel.θi	unhealthy
ˈwʌn.də.fəl.i	wonderfully
ˈhɔːl.weɪ	hallway
ˈdʒækɪt	jacket
ˈkwɔːrtər	quarter
ˈsɒk.ɪt	socket
ˈtɪs.juː	tissue
ˌsuː.pəˈnætʃ.ər.əl	supernatural
ˌrɪˈleɪ	relay
ˈtwen.tiz	twenties
kəˈrekt	correct
ˈkiː.nəʊt	keynote
ˈɡrʌm.pi	grumpy
ˈkɔː.pər.əl	corporal
ˈtʃɪəˌliː.dər	cheerleader
dɪˈskred.ɪt	discredit
næk	knack
ˈstəʊ.kər	stoker
fiːl	feel
ruːd	rude
ˈmeɪnli	mainly
ˈvɜːʃn	version
ˈʌpər	upper
ˈlemən	lemon
ˌʌn.əˈvɔɪ.də.bl̩	unavoidable
breθ	breath
ˈpɜː.tɪ.nənt	pertinent
fʊlˈfɪl	fulfil
ˈbɒk.sɪŋ	boxing
ˈaʊtpʊt	output
tʃɔːr	chore
prəˈfaʊnd	profound
kənˈsiːl	conceal
leŋθ	length
ədˈmɪn.ɪ.stər	administer
ˈʌndərwer	underwear
ˈbəʊ.lɪŋ	bowling
wuː	woo
ˈsmʌɡ.l̩	smuggle
sæd	sad
ˈfaɪ.lɪŋ	filing
ˌɔːltəˈɡeðər	altogether
ˌkɒn.trəˈsep.tɪv	contraceptive
ˈrʌn.ə.weɪ	runaway
ˈɡrædʒuəli	gradually
pəˈrəʊl	parole
ˈwɪʃfʊl	wishful
ˌæp.rəˈbeɪ.ʃən	approbation
kəˈmɪti	committee
ˈpɔɪzn	poison
ɑːrmd	armed
əˈreɪndʒmənt	arrangement
ɪˈnɪʃətɪv	initiative
ˈpɑːp.kɔːrn	popcorn
ˈper.ə.ɡræf	paragraph
ɪkˈspɔːt	export
taɪm	time
twiːk	tweak
ˈɡrænsʌn	grandson
ˈtrɪn.ɪ.ti	Trinity
ˈleðər	leather
teɪnt	taint
ˌsuː.ɪˈsaɪ.dəl	suicidal
ˈbjuː.tɪ.faɪ	beautify
flæŋk	flank
riːk	reek
ˈstjuːdiəʊ	studio
rɪˈsɜːrtʃ	research
ˈkɔːrnər	corner
ɡləʊb	globe
əˈmend	amend
ˈtel.ɪ.ɡræm	telegram
ˌiː.kwɪˈlɪb.ri.əm	equilibrium
fɔːs	force
ˈpɒsəbl	possible
ˌekspləˈneɪʃn	explanation
ˈvæli	valley
ˈfæn.tə.si	fantasy
ˈsɪnəmə	cinema
ˈhɒk.i	hockey
ɪˈvɪkt	evict
ədˈhɪər	adhere
ˈɑːnɪstli	honestly
ˈkɜːli	curly
tɪlt	tilt
fəˈɡɪv.nəs	forgiveness
ˈlɪə.ri	leery
əˈrəʊ.mə	aroma
mɔːrˈəʊvə(r)	moreover
ˈlɒb.i	lobby
ˈdʒʌm.pər	jumper
əbˈdʒektɪv	objective
bɑːrb	barb
fliː	flee,flea
ˈruːlə(r)	ruler
ˈnevər	never
ˈbiː.tl̩	beetle
fʌnd	fund
bəˈnɑː.nə	banana
ˈkɑː.dɪ.nəl	cardinal
əˈljʊər	allure
əˈpɪr	appear
ɪnˈstrʌkʃn	instruction
rɪˈstrɪkt	restrict
ˈkɑː.pi.ɚ	copier
ɪmˈpɒsəbl	impossible
ˈpɪt.fɔːl	pitfall
jʌŋ	young
fed	fed
ˈpɜːrmɪt	permit
ˈsel.si.əs	Celsius
ˈæktʃuəl	actual,actual
ˈrəʊ.ən	rowan
ˈiə.fəʊnz	earphones
fɔːrm	form
ɪnˈspek.tər	inspector
ˌkjʊr.iˈɑː.sə.t̬i	curiosity
ˈɡreɪ.ʃəs	gracious
ˈviː.zə	visa
bɪˈliː.vər	believer
əˈsʌn.dər	asunder
miːl	meal
ˈvəʊ.tɪŋ	voting
ˈbɑː.si	bossy
ˌref.əˈriː	referee
ˈkwɔːtə(r)	quarter
kræp	crap
ˈɡælən	gallon
ɪˈmjuːn	immune
ɑːˈdæs.ə.t̬i	audacity
truːθ	truth
drəʊv	drove
ˌɪntəˈrʌpt	interrupt
ˈfeɪljə(r)	failure
ˈtriː.ti	treaty
ˌkɒn.trəˈdɪk.ʃən	contradiction
raɪnd	rind
ˈʃɑːpɪŋ	shopping
kwɪlt	quilt
ɪnˈkʌm.bər	encumber
pɚˈfʌŋk.tɚ.i	perfunctory
sekt	sect
ˈrestrɒnt	restaurant
hens	hence
ɪˌlekˈtrɒnɪk	electronic
ˈseɪ.vər	savour
ˈtɒp.ləs	topless
ɡlænd	gland
weɪst	waste,waist
ˈreɪ.tɪŋ	rating
ˈdrɒp.ər	dropper
ˈpɜː.pə.treɪt	perpetrate
ˈkɒpi	copy
ˈtem.pl̩	temple
rɪˈsɪp.i.ənt	recipient
ˈbrʌðə(r)	brother
əˈpiːl	appeal
rɪˈmeɪnɪŋ	remaining
fəˈtæl.ə.ti	fatality
prɪˈdɒm.ɪ.nənt	predominant
kʌlt	cult
ˈvɪlɪdʒ	village
ˈhaɪ.brɪd	hybrid
ˈpeɪn.ləs	painless
dʒɪn	gin
lɒɡ	log
ˈblʌn.dər	blunder
ˈʃʌd.ər	shudder
ɪkˈsaɪtɪŋ	exciting
bʊʃ	bush
ˌdɪsəˈpɔɪntɪd	disappointed
ˈventʃə(r)	venture
dɪˈskʌr.ɪdʒ	discourage
wɔː(r)	war
sæp	sap
ˈskruːˌdraɪ.vər	screwdriver
ɡɔːl	gall
ɪnˈsted	instead
ˌæk.jʊˈzeɪ.ʃən	accusation
θrəʊn	throne
prɪˈten.ʃəs	pretentious
rɪˈdʒɔɪs	rejoice
ˈɒk.tə.pəs	octopus
əˈlɒŋ	along
trʌŋk	trunk
ʌnˈiː.zi	uneasy
ˈnɒs.trəl	nostril
ˈdʒæk.əl	jackal
ˈmɜː.meɪd	mermaid
dʒɔɪnt	joint
ˈvɜː.dɪkt	verdict
ˈlɪb.ər.əl	liberal
ˈpriː.tʃər	preacher
woʊ	woe
frɑːθ	froth
ˈpʌl.vər.aɪz	pulverize
tʃɪr	cheer
ˈtɜː.bjʊ.lənt	turbulent
mɑːm	mom
vaɪs	vice
ˌmet.rəˈpɒl.ɪ.tən	metropolitan
dæns	dance
ˈɒrɪndʒ	orange
ˌɑːbzərˈveɪʃn	observation
dɪˈlɪvə(r)	deliver
ˈreəli	rarely
prəˈdjuːsə(r)	producer
ˈræŋ.ɡəl	wrangle
kənˈstruː	construe
moʊn	moan
ˈmædʒ.ɪ.streɪt	magistrate
wɜːr	were
ɪnˈfjʊə.ri.eɪt	infuriate
ˈlæk.sə.tɪv	laxative
skwiːz	squeeze
ˈæn.ti	anti,ante
ˈkæbɪnət	cabinet
ˈmɪŋ.ɡl̩	mingle
ˈbaɪˌstæn.dər	bystander
ˈpeɪpər	paper
ˈæbsəluːtli	absolutely
ˈtʃɑː.mɪŋ	charming
ˈɒrɪdʒɪn	origin
ˈɔːkwəd	awkward
ˈpɜːrsn	person
duː	due,dew
keɪp	cape
ˌkɒn.fəˈmeɪ.ʃən	confirmation
zæp	zap
ˈneɪm.ləs	nameless
nekst	next
ˈwʊd.i	woody
əˈdrɔɪt	adroit
plɑːd	plod
ˈproʊ.lɑːɡ	prologue
ˈpɝː.pə.treɪ.t̬ɚ	perpetrator
ɡrɪp	grip
əˈbjuːs	abuse
ˈdʒɜːrmən	German
dens	dense
ˈhiː.tər	heater
jaʊl	yowl
brəʊk	broke
ˈrɪɡ.l̩	wriggle
bɪˈkeɪm	became
wɜːrld	world
ˈpeərənt	parent
sleɪ	sleigh,slay
ˈstɑːr.t̬l̩	startle
ˈmæn.ər	manor
ˈkəʊ.vɜːt	covert
left	left
məˈlɪʃ.əs	malicious
ˈdʒʌstɪfaɪ	justify
stæk	stack
ˈsəʊ.ləʊ.ɪst	soloist
ˈbæl.ət	ballot
sweə(r)	swear
hɑː	haw
ˈster.i.əʊ	stereo
θret	threat
kəˈneɪ.di.ən	Canadian
ˈprel.juːd	prelude
ˈsɑːri	sorry
ədˈvæns	advance
bəʊlt	bolt
kɔːrd	cord,chord
trəʊl	troll
ˈfeə.nəs	fairness
ˈsevrəl	several
ˈkuː.pər	cooper
ˈdiː.lər	dealer
ˈmɑː.dɪst	modest
ˈkəʊ.kə.nʌt	coconut
ɪnˈtɪm.ɪ.deɪt	intimidate
kɔɪl	coil
ɪnˈdef.ɪ.nət	indefinite
ruːl	rule
ˈflaʊər	flower,flour
ˈvæljuː	value
kənˈsɜːrnɪŋ	concerning
ɪnˈteɪl	entail
fɑːrm	farm
weərˈevə(r)	wherever
baɪˈɒɡ.rə.fi	biography
ˈprem.ə.tʃər	premature
ˈɒp.ər.ə.tɪv	operative
əˈvɜː.ʃən	aversion
ˈfiː.bl̩	feeble
dəˈmeɪn	domain
ʃɑːt	shot
ˌhedˈkwɔː.tər	headquarter
ˈhæv.ək	havoc
ɔːˈdeɪ.ʃəs	audacious
ˈfɑːloʊɪŋ	following
ˈkɒm.ɪk	comic
ˈlɒt.ər.i	lottery
ʌnˈfɪn.ɪʃt	unfinished
spæŋk	spank
bruː	brew
ˈspaɪdə(r)	spider
mɑːk	mark,mock
vəʊt	vote
ˈbɔːrɪŋ	boring
ləʊn	loan,lone
skaʊt	scout
ˈʃæloʊ	shallow
ˈdʒɪt̬.ɚ	jitter
tʊk	took
ˌkɑː.bəʊˈhaɪ.dreɪt	carbohydrate
ˈrʊm.meɪt	roommate
ˈbiː.vər	beaver
lɔːn	lawn
ˈɪləstreɪt	illustrate
nəʊn	known
ˈwɔː.mɪŋ	warming
klɑːt	clot
ˈsiː.krə.tɪv	secretive
rɒmp	romp
ˈdʒɑːn.t̬i	jaunty
ˈsæləri	salary
ˈriːdər	reader
naɪˈiːv	naive
ˈpeɪ.tənt	patent
ˈɪr.loʊb	earlobe
ɡreɪd	grade
kənˈfjuːz	confuse
pɑːd	pod
əˈliː.vi.eɪt	alleviate
wel	well
helθ	health
miːnz	means
ˈswiːt.nəs	sweetness
ˈreɪ.vən	raven
ˈnevə(r)	never
ʃoʊn	shown
læd	lad
ˈblɒs.əm	blossom
ˈpaʊə.ləs	powerless
ˌkɑː.nəˈsɝː	connoisseur
ˈɡrɪ.məs	grimace
blɑːtʃ	blotch
ˈpet.jʊ.lənt	petulant
ˈpəʊst.mən	postman
ˈpɔː.tə.bl̩	portable
ˈtruː.ənt	truant
əˈləʊn	alone
wɜːrst	worst
ˈplænɪt	planet
ˈhɒləʊ	hollow
ˈbiː.kən	beacon
ˈbɪl.i.ədz	billiards
ˈkɒz.mɪk	cosmic
smɔːl	small
ˈprɒfɪt	profit
ˈkeɪ.ɒs	chaos
ˈdɔː.mən	doorman
ˈhiː.ðən	heathen
dʒuːˈdɪʃ.əs	judicious
ˈtrænspɔːt	transport
wɪɡ	wig
blend	blend
ˈɡleɪ.si.ɚ	glacier
ˌdaʊnˈsterz	downstairs
ˈwaɪdli	widely
ˈneɪʃn	nation
rɒd	rod
ˈmaɪ.krə.weɪv	microwave
ˈbæl.eɪ	ballet
əˈbɔː.ʃən	abortion
ˈspaɪr.əl	spiral
rɒk	rock
ˈɪn.flʌks	influx
kəˈset	cassette
slɪk	slick
ˈɪn.tɪ.mə.si	intimacy
ˌæn.tiˈsiː.dənt	antecedent
jɒt	yacht
ˈæktə(r)	actor
hɔːk	hawk
ʃæft	shaft
pleɪt	plate
ˈpjuː.bə.ti	puberty
pest	pest
nɔːrθ	north
æʃ	ash
əˈpɪrəns	appearance
ˈwɔː.dən	warden
ˈbriːðɪŋ	breathing
noʊp	nope
ˈvaɪələnt	violent
dʌst	dust
ˈtræk.tər	tractor
məˈtɜː.nəl	maternal
θroʊt	throat
ˈsʌt.əl	subtle
ɡrɪt	grit
ˈɡlʌt.ən.i	gluttony
werˈevər	wherever
ˈvæm.paɪər	vampire
ˈnʌt̬.i	nutty
kənˈtemprəri	contemporary
ɪˈmjuː.nɪ.ti	immunity
ˈɪntənet	internet
hɒsˈtɪl.ɪ.ti	hostility
ˈɡɜː.dl̩	girdle
ɪnˈkləʊz	enclose
ˈspiːkə(r)	speaker
ˈmæn.deɪt	mandate
ɪˈnɜːt	inert
siːdʒ	siege
daɪˈvɜːt	divert
ˈkrɪs.tʃən	Christian
ˈek.stə.si	ecstasy
ˈblʌs.tər	bluster
snɑːb	snob
skʌl	skull
sɪˈment	cement
ˈɡreɪv.jɑːd	graveyard
viːl	veal
ˈbluːˌbər.i	blueberry
ˌkɒn.səˈveɪ.ʃən	conservation
hed	head
ˈerər	error
ˌsɪɡəˈret	cigarette
kɑːn	con
ˈvɜːʒn	version
klɒɡ	clog
saʊnd	sound
ˌkæf.əˈtɪə.ri.ə	cafeteria
ˈlev.ɚ.ɪdʒ	leverage
ˈmɪdʒ.ɪt	midget
ˈdev.ə.steɪ.tɪd	devastated
ˈpæs.tə	pasta
ˈbɔː.dəm	boredom
ˌsʌb.dɪˈvaɪd	subdivide
ˈmɔɪs.tʃər	moisture
ɪˈstæb.lɪʃ.mənt	establishment
ˈɪnfluəns	influence
ˈper.ə.sɑːl	parasol
ˌbækˈfaɪər	backfire
ˈtæŋ.ɡl̩	tangle
ˈfaɪn.dɪŋ	finding
dwɔːf	dwarf
ɪˈstiːm	esteem
ɑːˈkeɪ.ɪk	Archaic,archaic
prɑːmpt	prompt
ˈpref.ɪs	preface
ɡeɪdʒ	gauge
ˈɡlɔː.rɪ.faɪ	glorify
nɒt	not,knot
ˈkɪl.ər	killer
kəmˈpæʃ.ən.ət	compassionate
ˌmɪsˈpleɪs	misplace
ˈped.ɪ.ɡriː	pedigree
ˈrʌm.ɪdʒ	rummage
hɪmˈself	himself
ˈkɒn.təm.pleɪt	contemplate
ˈfɪk.l̩	fickle
ˈnjuː.tri.ənt	nutrient
klɪf	cliff
ʌnˈrɪəl	unreal
twɪn	twin
ˈpɜːfɪktli	perfectly
ˈfriː.weɪ	freeway
ˈməʊtə(r)	motor
ˈduː.ə.bl̩	doable
ɔːr	or,oar,ore
reɪndʒ	range
wɝːm	worm
krɑːft	craft
tʃəʊz	chose
dɪˈmɒk.rə.si	democracy
ˈlɒb.stər	lobster
ˈkjuː.bɪ.kl̩	cubicle
ˈɪsjuː	issue
ˈtʃeɪn.dʒɪŋ	changing
ˈbæləns	balance
ˌnaɪnˈtiːn	nineteen
ˈæb.i	abbey
dʒɪŋkst	jinx
ɔː	awe
ɡɔːz	gauze
lɔːrd	lord
ˈdɪɡ.nɪ.faɪ	dignify
kləʊn	clone
flɑːk	flock
ˌdɪs.rɪˈɡɑːd	disregard
dɪˈdʌkt	deduct
ˈwʌndər	wonder
ɡaɪ	guy
huːm	whom
ˈpoʊ.ət	poet
ˈsɪmələrli	similarly
ˈɒn.ər.ə.bl̩	honourable
əˈkɔːrdɪŋ	according
ˈɔːlməʊst	almost
rɪˈlɪŋ.kwɪʃ	relinquish
stɔːntʃ	staunch
ˈɪm.pɪʃ	impish
əˈses.mənt	assessment
kəˈmɪt	commit
rek	wreck
əˈmeɪzɪŋ	amazing
rɪˈtaɪərd	retired
θrɪl	thrill
ˌkɒn.frʌnˈteɪ.ʃən	confrontation
əˈtrɪʃ.ən	attrition
tʌŋ	tongue
fɑːm	farm
rɪˌspɑːnsəˈbɪləti	responsibility
stɜːn	stern
ˈrɔɪ.əl.ti	royalty
ˈeniweɪ	anyway
ˈkɪ.ti	kitty
kləʊv	clove
əˈpɑːt	apart
mɪˈstɪriəs	mysterious
liːp	leap
əˈnæləsɪs	analysis
ɪmˈpɑː.ʃəl	impartial
ˈmɔː.nɪŋ	mourning
ˈsɪm.fə.ni	symphony
əˈsliːp	asleep
drest	dressed
mɪˈlen.i.əm	millennium
bʌlk	bulk
ˌæk.wɪˈzɪʃ.ən	acquisition
triː	tree
ˌpɪə.riˈɒd.ɪk	periodic
ləˈɡuːn	lagoon
ˈpɑːpjələr	popular
ˈfɪl.ɪŋ	filling
kəmˈpaɪl	compile
rɪˈpʌl.sɪv	repulsive
ˈbeɪ.kən	bacon
mɔːˈræl.ə.t̬i	morality
dekˈster.ə.ti	dexterity
ɜːn	earn,urn
lɑːɡ	log
rɪˈzɑːlv	resolve
skwɪnt	squint
snæɡ	snag
ˈæk.tɪ.veɪt	activate
ˈkʌm.bə.səm	cumbersome
ˈhʌri	hurry
ˈbɔɪfrend	boyfriend
ˈneɪtʃər	nature
ˈprɪnsəpl	principle
ˈred.ɪ.li	readily
ɔːlˈtɜːnətɪv	alternative
ˈfeɪvər	favour
ˈhjuːmər	humour
ʃuːt	shoot
ˈsoʊldʒər	soldier
esˈθet.ɪk	aesthetic
vaɪl	vile
ˈslɑː.t̬ɚ	slaughter
ˈjuːnɪfɔːm	uniform
rɪˈplaɪ	reply
nɔːr	nor
ʌnˈkɑːnʃəs	unconscious
pʌls	pulse
ˈɔː.dɪ.tər.i	auditory
haɪd	hide
dɪˈmjʊər	demure
ˈlækɪŋ	lacking
ˈsaɪ.prəs	cypress
ˈaɪ.sɪ.kl̩	icicle
ˈoʊ.vɚ.doʊs	overdose
lætʃ	latch
ˈskæf.əl.dɪŋ	scaffolding
ðə	the
niːs	niece
ˈʃɔːrtli	shortly
ˈɡʌvənə(r)	governor
ˈkɑːnstəntli	constantly
ˈstreŋ.θən	strengthen
ˈwɔː.tə.fɔːl	waterfall
ɪnˈtʃɑːnt	enchant
ˈsʌmwʌn	someone
dʌb	dub
fɑːɡ	fog
ˈkɑːrdbɔːrd	cardboard
ˈɡræn.jʊ.leɪ.tɪd	granulated
ˈprəʊɡres	progress
ˈɜːdʒənt	urgent
ˌnæʃ.ənˈæl.ə.ti	nationality
ˈaɪ.vi	ivy
ˌəʊ.vəˈlæp	overlap
ˈfriːkwəntli	frequently
ɪɡˈnɔːr	ignore
ˈpɑːləsi	policy
əbˈsɜːd	absurd
ˈpɑːspɔːt	passport
prɪˈlɪm.ɪ.nər.i	preliminary
ˈrʌnɪŋ	running
ˌʌpˈtaʊn	uptown
ˈhaɪər	hire
ˈhəʊmwɜːk	homework
ˈæp.ɪ.taɪt	appetite
ˈlet.ɪŋ	letting
ləʊd	load
niːt	neat
ˈheə.ri	hairy
ˌpɑː.pjəˈler.ə.t̬i	popularity
ˈveɪ.kən.si	vacancy
smoʊk	smoke
lʌk	luck
dɪˈsɪn.tɪ.ɡreɪt	disintegrate
ˈruː.bɑːb	rhubarb
ˈspæn.jəd	Spaniard
ˈtækl	tackle
əˈbəʊd	abode
ˈhɒl.ər	holler
ˌpɑːsəˈbɪləti	possibility
dɪˈvaɪn	divine
ˈtrəʒərɪ	treasury
ˈæʤəleɪt	adulate
ˌdʒaɪˈɡæn.tɪk	gigantic
ɡɪr	gear
ɪkˈspreʃn	expression
ˈsæm.ən	salmon
bælˈeɪ	ballet
ˈtʃɑːn.səl.ər	chancellor
ˌɒp.tɪˈmɪs.tɪk	optimistic
ˈpɪk.ɪt	picket
ˈbetə(r)	better
heər	hare
rʌɡ	rug
ˌkɑːz.məˈpɑː.lɪ.t̬ən	cosmopolitan
doʊm	dome
kənˈdəʊl	condole
ʃʊə(r)	sure
ˈrʌs.ti	rusty
səˈpɔː.tɪŋ	supporting
dɒt	dot
əˈmjuːzɪŋ	amusing
ˈhɑːt.ləs	heartless
ˈslɑːn.dər	slander
ˈɡrʌm.bl̩	grumble
jes	yes
pruːf	proof
ˈhɪərəʊ	hero
əˈwer	aware
ˈkɑːŋ.kɚ	conquer
ˈrep.taɪl	reptile
sprʌŋ	sprung
tə	to
ɡraʊnd	ground
ˈɪnsɪdənt	incident
ˈklem.ənt	clement
jɪə(r)	year
ˈdezət	desert
ɡəʊld	gold
əˈpɪnjən	opinion
əˈnɔɪ.əns	annoyance
ˈɪntrəstɪŋ	interesting
ˈɡɒdˌfɑː.ðər	godfather
ˈfreʃ.ən	freshen
ˈdemənstreɪt	demonstrate
ˈhaɪə.lɪŋ	hireling
ruːz	ruse
ˌkɒm.penˈseɪ.ʃən	compensation
ˈhʌn.i.muːn	honeymoon
vaɪn	vine
mɒsk	mosque
ɡləʊ	glow
ˈfɜːmli	firmly
ˈbuː.ti	booty
meʃ	mesh
aʊt	out
ˈraɪ.ə.təs	riotous
ˈmeɪ.ni.ə	mania
ˈwɒʃɪŋ	washing
ɡɪˈtɑː	guitar
soʊld	sold
əˈdɑːpt	adopt
dɪˈstɜːbɪŋ	disturbing
ˈfɒr.ɪd	forehead
hoʊz	hose
ˌdaɪˈmen.ʃən	dimension
ˈɪm.ɪ.ɡrənt	immigrant
ˈjestərdeɪ	yesterday
ɡrɪld	grilled
ˈpʊd.ɪŋ	pudding
kənˈstrʌkʃn	construction
rɪˈhɜː.səl	rehearsal
ˈskiː.ɪŋ	skiing
rɪˈses	recess
ˈəʊ.bə.ʒiːn	aubergine
ˈnjuː.səns	nuisance
ˈtʃɪə.ləs	cheerless
ˈkɒnsntreɪt	concentrate
fluː	flew,flu
ˈkændɪdət	candidate
əˈplaɪ	apply
ˈflæt.ən	flatten
dʒæb	jab
ɪn	in,inn
ɪnˈdɪɡ.nənt	indignant
ɪkˈspəʊz	expose
ˈkəʊ.dʒənt	cogent
ˈstʌm.bl̩	stumble
ˈrɒb.ər	robber
kəʊks	coax
stɑːrtʃ	starch
ˈləʊ.kəst	locust
spuːn	spoon
ˈbɑːroʊ	borrow
bred	bread
laʊndʒ	lounge
prəˈduːsər	producer
ˈsɔː.dɪd	sordid
ˈkɒk.i	cocky
əˈlaɪv	alive
ˈneɡ.lɪ.dʒəns	negligence
ˈmæm.əθ	mammoth
ˈtaɪ.mər	timer
əˈten.dənt	attendant
ˈlɒl.i.pɒp	lollipop
ˈbel.i	belly
ˈbrʌð.ə.hʊd	brotherhood
ˈbædʒ.ər	badger
hoʊˈtel	hotel
ˈpriː.vi.əs.li	previously
tæn	tan
skreɪp	scrape
ˈʌpˌraɪ.zɪŋ	uprising
ˈpɪr.ə.mɪd	pyramid
faɪv	five
ˈæɡ.ə.ni	agony
slɒt	slot
ræmp	ramp
ˈlaɪk.waɪz	likewise
prəˈmoʊʃn	promotion
koʊks	coax
ˈɪn.sjʊ.lər	insular
poʊˈler.ə.t̬i	polarity
sloʊ	slow
ˈkæmpɪŋ	camping
vɑːst	vast
lʌmp	lump
ˈkɑː.skɪt	casket
ɪˌlekˈtrɒn.ɪks	electronics
ɪmˈpek.ə.bl̩	impeccable
ˈləʊn.səm	lonesome
ˈhaɪnd.saɪt	hindsight
ˈpiː.vɪʃ	peevish
ˈstedi	steady
krɒp	crop
ˈfɔːrmərli	formerly
ˈaʊtset	outset
təʊst	toast
ˈkuː.pɒn	coupon
bɪˈstəʊ	bestow
ˌkɑːnvərˈseɪʃn	conversation
sɪˈdjuːs	seduce
ˈsuː.ɚ	sewer
bɜːtʃ	birch
ˈkæv.əl.ri	cavalry
pɜːk	perk
ˈriːˈset	reset
kəʊl	coal
pəˈfɔːməns	performance
vɝːs	verse
ˈstiː.pl̩	steeple
ɑːrt.si	artsy
rɪˈmembər	remember
ɪˈkɑːnəmi	economy
meər	mare
kɒn	con
ˈfer.i	fairy,ferry
ˈɒn.ə.sti	honesty
dɪˈpen.dənt	dependent
ˈpɜː.fjuːm	perfume
ˈpoʊəm	poem
fraɪ	fry
vəˈkeɪʃn	vacation
ˈkɑːnfɪdəns	confidence
ˌkɒmpəˈtɪʃn	competition
ˈpraɪs.ləs	priceless
klɔː	claw
kɑːst	cast
ˈʃæɡ.i	shaggy
fænˈtæs.tɪk	fantastic
ˈvaɪ.breɪt	vibrate
tʃɜːp	chirp
kʌp	cup
ˈklaɪənt	client
ˈhɑːr.t̬i	hearty
baʊ	bow,bough
ˈsplen.dɪd	splendid
ˈteks.tʃər	texture
ɪˈræʃ.ən.əl	irrational
ˈkrɑː.nɪk	chronic
jɔːˈself	yourself
kriːs	crease
ˈdʒɜː.zi	jersey
ˈdefɪnətli	definitely
ˈkɒnsept	concept
ˌʌpˈtaɪt	uptight
ˈkræŋ.ki	cranky
dɪˈmɪn.ɪʃ	diminish
ˈfɔː.dʒər.i	forgery
ɪnˈtaɪərli	entirely
dɪˈməʊt	demote
dɪˈvɝːs	diverse,diverse
fɪˈziːk	physique
ˈnetwɜːrk	network
ɒkˈtəʊbə(r)	October
ˈkʌl.ə.fəl	colourful
dæmp	damp
ˈklær.ɪ.ti	clarity
dɪˈskʌs	discuss
ˈwɪntə(r)	winter
sɪɡˈnɪfɪkəntli	significantly
ˈkɒl.ə.nist	colonist
pəˈsweɪ.sɪv	persuasive
ˈweə.ri	wary
ˈsiː.ʒər	seizure
hi	he
ɪnˈdiː.sənt	indecent
ˈɒnˌkʌm.ɪŋ	oncoming
rɪˈsaɪt	recite
ˈrekɔːd	record
ɪˈvent	event
kɜːs	curse
ˈter.ər	terror
rɪˈfɜː(r)	refer
ðerz	theirs
rɪˈzɜːrvd	reserved
əˈbʌv	above
əˈbɒr.ənt	abhorrent
ˈprɪv.əl.ɪdʒ	privilege
ˈtɒn.səlz	tonsil
ˈɑː.t̬ɚ	otter
ˈæŋ.ɡwɪʃ	anguish
kwentʃ	quench
ˈeldərli	elderly
kənˈteɪ.dʒən	contagion
ˈɒk.saɪd	oxide
ˈhevn	heaven
ˈmɑːkɪtɪŋ	marketing
əˈblaɪdʒ	oblige
ˌəʊ.vəˈduː	overdo
ˈdæf.ə.dɪl	daffodil
ˈdɒm.ɪ.saɪl	domicile
ˈbrɪt.l̩	brittle
ləʊˈkeɪtɪd	located
ɪkˈstɪŋ.ɡwɪʃ	extinguish
ˌpɝː.səˈvɪr.əns	perseverance
ˌaʊtˈsaɪ.dər	outsider
ˈlænd.mɑːk	landmark
aʊtˈstændɪŋ	outstanding
pəʊtʃ	poach
ˈred.hed	redhead
ˈnəʊ.mæd	nomad,nomad
ˈkɒtn	cotton
kaɪnd	kind
əˈɡəʊ	ago
skɔː(r)	score
ˌəʊ.vəˈdjuː	overdue
ˈsmuːðli	smoothly
əˈraʊnd	around
ˈkɑː.ləm.nɪst	columnist
ˈaɪðə(r)	either
ɑːrt	art
ˈheɪ.sti	hasty
pɜːt	pert
əˈfreɪd	afraid
prɪˈtend	pretend
ˈkænɑːt	cannot
ˈbaɪ.bl̩	Bible
ˈsɪk.nəs	sickness
sɑː	saw
ˈfluːɪd	fluid
ˈplʌm.ɪŋ	plumbing
ˈeɪdʒənt	agent
əˈriː.nə	arena
ˈkʊr.i.ər	courier
ɒsˈten.sɪ.bl̩	ostensible
rɪˈɡret.fəl	regretful
ˌkɒm.pəˈzɪʃ.ən	composition
ˈælkəhɒl	alcohol
ˈfiːvə(r)	fever
ˈstændəd	standard
rɪˈmuːv	remove
ɪmˈpresɪv	impressive
ˈsliː.zi	sleazy
krəʊk	croak
ˈkænɒt	cannot
diːvæljʊˈeɪʃn	devaluation
spəˈsɪfɪk	specific
stiːp	steep
ˈkʌpl	couple
ˈfɔːmjələ	formula
trænsˈfɜː(r)	transfer
blaʊs	blouse
dɪˈzaɪə.rə.bl̩	desirable
ˈpiː.tʃi	peachy
ˈɒfɪsə(r)	officer
ˌɒpəˈreɪʃn	operation
mɔːl	mall
stʌft	stuffed
ˈspiː.ʃiːz	species
dɪˈmɒl.ɪʃ	demolish
ˌæl.əˈɡeɪ.ʃən	allegation
ˈpɜː.pə.treɪ.tər	perpetrator
ɡeɪm	game
wɪðˈdrɔː.əl	withdrawal
sɪndʒ	singe
ˈjeləʊ	yellow
ˈsel.jʊ.lər	cellular
ɪˈsenʃəli	essentially
dʒɪmˈneɪ.zi.əm	gymnasium
lʌl	lull
fleks	flex
ˈprev.əl.ənt	prevalent
maɪl	mile
ˈθɜːzdeɪ	Thursday
ˈʃeltə(r)	shelter
ˈɡroʊ.sɚ	grocer
ˈlɪvɪŋ	living
ˈdʒuː.bɪ.liː	jubilee
dɪˈmaɪz	demise
ʃəʊ	show
kənˈsɜːv	conserve
dɪˈbeɪ.tə.bl̩	debatable
ˈblæk.nəs	blackness
ˈpleznt	pleasant
ˈkaʊ.əd	coward
ˈkɑːnflɪkt	conflict
ˈɡrænfɑːðə(r)	grandfather
kɝːs	curse
ˈɔːɡənaɪz	organize
ˈfæsn	fasten
rɪˈtɑːd	retard
ˈruː.ɪ.nəs	ruinous
jɑːrd	yard
ˈleftˌəʊ.vər	leftover
ˈproʊ.t̬ə.kɑːl	protocol
ˈeksəsaɪz	exercise
ˈhoʊli	holy
ˈɪndʒərd	injured
ˈklʌm.zi	clumsy
əˈdɔːn	adorn
ˈdɑː.dʒi	dodgy
kəmˈpjuːtər	computer
ˈfɪl.ɪt	fillet
sɪˈkluːd	seclude
skroʊl	scroll
ˈreɪn.dʒər	ranger
əʊts	oats
ˈleɪtər	later
ˈpres.ɪ.dənt	precedent
ˈtʃer.ɪʃ	cherish
kəˈmens	commence
kɑːk	cock
rəʊst	roast
bɪˈweər	beware
ˌriːˈwaɪnd	rewind
θaɪ	thigh
ˈfɔː.mə.li	formally
pɑːk	park
ˈɡet̬.oʊ	ghetto
ˈdʒɔɪ.əs	joyous
rɑːmp	romp
wɜːs	worse
pjʊr	pure
dɪˈspleɪ	display
ˈhaʊshəʊld	household
koʊˈɑː.pɚ.ə.t̬ɪv	cooperative
əˈten.tɪv	attentive
ˈsʌn.i	sonny,sunny
ˈstɔː.rɪdʒ	storage
ˈfɪk.sɪŋ	fixing
ˌpɝː.pənˈdɪk.juː.lɚ	perpendicular
ˌrev.əˈluː.ʃən.ər.i	revolutionary
prəˈvəʊk	provoke
ˈpiːp.həʊl	peephole
wɪp	whip
kənˈsɪdə(r)	consider
ˈɒbdʒɪkt	object
ˈsɪriəs	serious
træʃ	trash
ˈdʒʌm.bəʊ	jumbo
ˈdæŋ.ɡl̩	dangle
ˈɡʌl.ə.bl̩	gullible
ˈhæm.ək	hammock
ˌkleəˈvɔɪ.ənt	clairvoyant
ˈdʒɔɪ.fəl	joyful
tʃaɪld	child
ˈpɪə.ləs	peerless
pərˈsuː	pursue
ˈpɔːr.əs	porous
kɝːb	kerb
weɪv	wave
ɡrəʊp	grope
ˈsek.si	sexy
dəˈrektə(r)	director
ˈwɜːʃɪp	worship
ˈɜː.nɪŋz	earnings
ˈnæv.ɪ.ɡə.bl̩	navigable
fɔːrdʒ	forge
ˈtɑː.di	tardy
braɪd	bride
paʊns	pounce
ˈfɔːr.moʊst	foremost
ˈɪŋ.kwɚ.i	inquiry
ˈkrɒs.ɪŋ	crossing
ˈbrəʊ.ʃər	brochure
lɑːst	last
ˈblen.dər	blender
ˌsɜː.kəmˈvent	circumvent
əˈtempt	attempt
ˈvɪzɪt	visit
ˈbeə.rɪŋ	bearing
ˌdʒʊə.rɪsˈdɪk.ʃən	jurisdiction
ˈself.ləs	selfless
kəˈpriːs	caprice
ˈdʒʌstɪfaɪd	justified
ˈsəʊɪŋ	sewing
ˈmɑː.mi	mommy
bliːk	bleak
ˈbʌdʒɪt	budget
hɪˈrəʊ.ɪk	heroic
kənˈfaɪn	confine
ɪnˈdiːd	indeed
ˈhevi	heavy
wəʊk	woke
dəˈrektli	directly
ɪˈdɪʃn	edition
ˈlɪr.i	leery
ɡlɪmps	glimpse
əˈledʒ	allege
strɒŋ	strong
ˈsə.maɪz	surmise
rɪˈmɪs	remiss
ɡleɪz	glaze
ˌrekəɡˈnɪʃn	recognition,recognition
ˌɔːtəˈmætɪk	automatic
pɔɪz	poise
ˈhɜː.dl̩	hurdle
tʃiːk	cheek
vɜːb	verb
ɔːˈθen.tɪk	authentic
ˈfiː.zə.bl̩	feasible
ˈæŋɡər	anger
kəˈrʌpt	corrupt
fəˈɡɪv.ɪŋ	forgiving
ˌendʒɪˈnɪrɪŋ	engineering
sɒd	sod
ˈkɑːlɪdʒ	college
ˌʌnˈnoʊn	unknown
ˈspeʃəlɪst	specialist
ˌdʒenəˈreɪʃn	generation
sɪks	six
ˈɒn.laɪn	online
əˈsʌmp.ʃən	assumption
ˈkɒm.ən.welθ	commonwealth
ˈmoʊmənt	moment
ˈhɑːrd.wer	hardware
rɪˈmɑːrkəbl	remarkable
ɪnˈtɛnʃ(ə)nəli	intentionally
ˈdiːteɪl	detail
ˈfʌŋ.ki	funky
ˈæspən	aspen
ɪnˈvæl.jʊ.bl̩	invaluable
ˈæb.sənt.li	absently
ˌmɪsˈliːd	mislead
ˈʌɡli	ugly
wet	wet,whet
ˈʃɔːli	surely
ˌɪn.ɪkˈsplɪk.ə.bl̩	inexplicable
foʊn	phone
ˌɒpəˈzɪʃn	opposition
liːk	leak
səˈmes.tɚ	semester
trænsˈfɔːm	transform
ˈʃedjuːl	schedule
ækt	act
ɡriːn	green
bʌst	bust
wɪŋ	wing
ɡræs	grass
prɒmpt	prompt
ˈswetə(r)	sweater
kʌm	come
ˈpəʊ.lər	polar
ˈθrɪlɪŋ	thrilling
ʌnˈnætʃ.ər.əl	unnatural
bredθ	breadth
ˈvɪzɪtər	visitor
ɪkˈskluː.sɪv	exclusive
ˈləʊ.kəl.i	locally
hæʃ	hash
ɪkˈstriːmli	extremely
ɪmˈplɔɪər	employer
slɪŋ	sling
əˈkruː	accrue
dʒel	gel,jell
skwɑːt	squat
kəʊˈɔː.dɪ.neɪt	coordinate
ɪˈluː.sɪv	elusive
ˈher.oʊ	harrow
næp	nap
ˈpeɪ.rəʊl	payroll
ˈten.ənt	tenant
ˌpɔː.tʃəˈɡiːz	Portuguese
fɪntʃ	finch
ˈneɪ.zəl	nasal
ɡəʊt	goat
ˈəʊ.vəl	oval
kriː.pɪŋ	creeping
ˈklɜː.dʒi	clergy
ˈnæroʊ	narrow
hɪˈstɒrɪkl	historical
oʊθ	oath
ˈhəʊm.taʊn	hometown
ˈtʃæt.ə.bɒks	chatterbox
ˈpɪə.sɪŋ	piercing
əˈdæpt	adapt
ɪnˈkluːd	include
ˈɡɑːdˌfɑː.ðɚ	godfather
ˈtræn.zi.ənt	transient
ˌʌnˈloʊd	unload
ˈduː.dl̩	doodle
ˈreə.rə.ti	rarity
waɪ	why
huːˈevər	whoever
sɪˈmes.tər	semester
əˈsəʊʃieɪt	associate
ˈskɑː.ləp	scallop
ˈbev.ər.ɪdʒ	beverage
ˈbeɪbi	baby
əˈdɒpt	adopt
pɚˈsuːt	pursuit
ˈkʌv.ɪ.təs	covetous
læks	lax
speɪs	space
ˈpjʊəli	purely
hɑːp	hop,harp
səˈɡeɪ.ʃəs	sagacious
ˈiːvl	evil
bɜːrθ	birth
pəʊz	pose
ɪˈklɪps	eclipse
kəmˈpliːtli	completely
ˌkɒr.əˈneɪ.ʃən	coronation
ˈær.ə.bl̩	arable
ɡɜːl	girl
ˈæm.bi.ənt	ambient
ˈklɑːs.meɪt	classmate
pliːd	plead
rɪˈkwaɪə(r)	require
floʊt	float
ˈsen.tɪ.nəl	sentinel
ˈɡɔː.di	gaudy
ˈlɑː.li.pɑːp	lollipop
ˈpɒp.jʊ.leɪt	populate
ˈkænsl	cancel
ˈwɒr.i.ər	warrior
ˈkæt.l̩	cattle
ɪˈnɪɡ.mə	enigma
ˈpruː.dənt	prudent
ˈklaɪmət	climate
ɑːkˈtoʊbər	October
ˈrɑː.ki	rocky
kləʊz	close
læɡ	lag
ˈplaɪ.ə.bl̩	pliable
ˈdeɪ.bju	debut
ˈter.ə.rɪst	terrorist
ɪkˈstɜː.mɪ.neɪt	exterminate
ˈeə.res	heiress
ˌæftərˈnuːn	afternoon
prəˈpoʊz	propose
ɑːdz	odds
ˈhɑː.ki	hockey
ˈrʌn.weɪ	runway
ˌsuː.vənˈɪər	souvenir
pɑːr	par
ˈpʌŋk.tʃər	puncture
ˈskedʒuːl	schedule
fruːt	fruit
ˈkɑː.stuːm	costume
ˈfɪʃ.ə.mən	fisherman
ʃɪər	sheer,shear
rɪˈnaʊn	renown
ˈpred.ɪ.kət	predicate
sɜːv	serve
